SUBVENTION_SCHEDULE_ID,LOAN_ID,CORE_LOAN_ID,ARN,DUE_DATE,CLOSED_DATE,TENOR,INSTALLMENT_NO,TRANS_TYPE,PRINCIPAL,CARRYING_AMT,SUBVEN_AMT,MONTHLY_RATE,EFFECTIVE_RATE,PRINCIPAL_AMT,INTEREST_AMT,EFFECTIVE_INT,SUBVEN_AMORTI,SUBVEN_BALANCE,PARTNER_ID,PARTNER_CODE,PRODUCT_CODE,SPECIAL_CODE,CAMPAIGN_CODE,BRANCH_CODE,STATUS,CREATOR,CREATE_DATE,MODIFIER,MODIFY_DATE,TRANS_DATE
1070,2012051864,100235483,2012070001673195,30SEP2021:00:00:00,,12,10,SUBVENTION_AMORTIZATION_VAT_POST,3481478,3428778,52700,3.750000,4.555218,1118041,130555,156188,25633,27067,114,TVT1,SFNFIX,FT2WZO,FT2WZO,17,1,baont,09DEC2020:14:55:57,,,
1071,2012051864,100235483,2012070001673195,31OCT2021:00:00:00,,12,11,SUBVENTION_AMORTIZATION_VAT_POST,2363437,2336370,27067,3.750000,4.555218,1159967,88629,106427,17798,9269,114,TVT1,SFNFIX,FT2WZO,FT2WZO,17,1,baont,09DEC2020:14:55:57,,,
1072,2012051864,100235483,2012070001673195,30NOV2021:00:00:00,,12,12,SUBVENTION_AMORTIZATION_VAT_POST,1203470,1194201,9269,3.750000,4.555218,1203470,45130,54398,9269,0,114,TVT1,SFNFIX,FT2WZO,FT2WZO,17,1,baont,09DEC2020:14:55:57,,,
1073,2012051849,100235493,2012050001673144,08DEC2020:00:00:00,,12,0,DISBURSE_SUBVENTION_VAT,10000000,8636364,1363636,3.750000,6.352556,,,,1363636,1363636,13,TGDD1,SFNFIX,FTCDZO,FTCDZO,45,1,baont,09DEC2020:14:55:57,,,
1074,2012051849,100235493,2012050001673144,08DEC2020:00:00:00,,12,0,DISBURSE_SUBVENTION_VAT_TOTAL,10000000,8636364,1363636,3.750000,6.352556,,,,1500000,1363636,13,TGDD1,SFNFIX,FTCDZO,FTCDZO,45,1,baont,09DEC2020:14:55:57,,,
1075,2012051849,100235493,2012050001673144,08DEC2020:00:00:00,,12,0,DISBURSE_SUBVENTION_VAT_AMT,10000000,8636364,1363636,3.750000,6.352556,,,,136364,1363636,13,TGDD1,SFNFIX,FTCDZO,FTCDZO,45,1,baont,09DEC2020:14:55:57,,,
1076,2012051849,100235493,2012050001673144,31DEC2020:00:00:00,,12,1,SUBVENTION_AMORTIZATION_VAT,10000000,8636364,1363636,3.750000,6.352556,675123,375000,548630,173630,1190006,13,TGDD1,SFNFIX,FTCDZO,FTCDZO,45,1,baont,09DEC2020:14:55:57,,,
1077,2012051849,100235493,2012050001673144,31JAN2021:00:00:00,,12,2,SUBVENTION_AMORTIZATION_VAT,9324877,8134871,1190006,3.750000,6.352556,700440,349683,516772,167089,1022917,13,TGDD1,SFNFIX,FTCDZO,FTCDZO,45,1,baont,09DEC2020:14:55:57,,,
1078,2012051849,100235493,2012050001673144,28FEB2021:00:00:00,,12,3,SUBVENTION_AMORTIZATION_VAT,8624437,7601520,1022917,3.750000,6.352556,726707,323416,482891,159475,863442,13,TGDD1,SFNFIX,FTCDZO,FTCDZO,45,1,baont,09DEC2020:14:55:57,,,
1079,2012051849,100235493,2012050001673144,31MAR2021:00:00:00,,12,4,SUBVENTION_AMORTIZATION_VAT,7897730,7034288,863442,3.750000,6.352556,753958,296165,446857,150692,712750,13,TGDD1,SFNFIX,FTCDZO,FTCDZO,45,1,baont,09DEC2020:14:55:57,,,
1080,2012051849,100235493,2012050001673144,30APR2021:00:00:00,,12,5,SUBVENTION_AMORTIZATION_VAT,7143772,6431022,712750,3.750000,6.352556,782232,267891,408534,140643,572107,13,TGDD1,SFNFIX,FTCDZO,FTCDZO,45,1,baont,09DEC2020:14:55:57,,,
1081,2012051849,100235493,2012050001673144,31MAY2021:00:00:00,,12,6,SUBVENTION_AMORTIZATION_VAT,6361540,5789433,572107,3.750000,6.352556,811565,238558,367777,129219,442888,13,TGDD1,SFNFIX,FTCDZO,FTCDZO,45,1,baont,09DEC2020:14:55:57,,,
1082,2012051849,100235493,2012050001673144,30JUN2021:00:00:00,,12,7,SUBVENTION_AMORTIZATION_VAT,5549975,5107087,442888,3.750000,6.352556,841999,208124,324431,116307,326581,13,TGDD1,SFNFIX,FTCDZO,FTCDZO,45,1,baont,09DEC2020:14:55:57,,,
1083,2012051849,100235493,2012050001673144,31JUL2021:00:00:00,,12,8,SUBVENTION_AMORTIZATION_VAT,4707976,4381395,326581,3.750000,6.352556,873574,176549,278331,101782,224799,13,TGDD1,SFNFIX,FTCDZO,FTCDZO,45,1,baont,09DEC2020:14:55:57,,,
1084,2012051849,100235493,2012050001673144,31AUG2021:00:00:00,,12,9,SUBVENTION_AMORTIZATION_VAT,3834402,3609603,224799,3.750000,6.352556,906333,143790,229302,85512,139287,13,TGDD1,SFNFIX,FTCDZO,FTCDZO,45,1,baont,09DEC2020:14:55:57,,,
1085,2012051849,100235493,2012050001673144,30SEP2021:00:00:00,,12,10,SUBVENTION_AMORTIZATION_VAT,2928069,2788782,139287,3.750000,6.352556,940320,109803,177159,67356,71931,13,TGDD1,SFNFIX,FTCDZO,FTCDZO,45,1,baont,09DEC2020:14:55:57,,,
1086,2012051849,100235493,2012050001673144,31OCT2021:00:00:00,,12,11,SUBVENTION_AMORTIZATION_VAT,1987749,1915818,71931,3.750000,6.352556,975582,74541,121703,47162,24769,13,TGDD1,SFNFIX,FTCDZO,FTCDZO,45,1,baont,09DEC2020:14:55:57,,,
1087,2012051849,100235493,2012050001673144,30NOV2021:00:00:00,,12,12,SUBVENTION_AMORTIZATION_VAT,1012167,987398,24769,3.750000,6.352556,1012167,37956,62725,24769,0,13,TGDD1,SFNFIX,FTCDZO,FTCDZO,45,1,baont,09DEC2020:14:55:57,,,
1088,2012051860,100235503,2012050001673147,08DEC2020:00:00:00,,12,0,DISBURSE_SUBVENTION_VAT_POST,12999000,12408136,590864,3.750000,4.555222,,,,590864,590864,114,TVT1,SFNFIX,NP2WZO,NP2WZO,17,1,baont,09DEC2020:14:55:57,,,
1089,2012051860,100235503,2012050001673147,08DEC2020:00:00:00,,12,0,DISBURSE_SUBVENTION_VAT_TOTAL_POST,12999000,12408136,590864,3.750000,4.555222,,,,649950,590864,114,TVT1,SFNFIX,NP2WZO,NP2WZO,17,1,baont,09DEC2020:14:55:57,,,
1090,2012051860,100235503,2012050001673147,08DEC2020:00:00:00,,12,0,DISBURSE_SUBVENTION_VAT_AMT_POST,12999000,12408136,590864,3.750000,4.555222,,,,59086,590864,114,TVT1,SFNFIX,NP2WZO,NP2WZO,17,1,baont,09DEC2020:14:55:57,,,
1091,2012051860,100235503,2012050001673147,31DEC2020:00:00:00,,12,1,SUBVENTION_AMORTIZATION_VAT_POST,12999000,12408136,590864,3.750000,4.555222,877592,487463,565218,77755,513109,114,TVT1,SFNFIX,NP2WZO,NP2WZO,17,1,baont,09DEC2020:14:55:57,,,
1092,2012051860,100235503,2012050001673147,31JAN2021:00:00:00,,12,2,SUBVENTION_AMORTIZATION_VAT_POST,12121408,11608299,513109,3.750000,4.555222,910502,454553,528784,74231,438878,114,TVT1,SFNFIX,NP2WZO,NP2WZO,17,1,baont,09DEC2020:14:55:57,,,
1093,2012051860,100235503,2012050001673147,28FEB2021:00:00:00,,12,3,SUBVENTION_AMORTIZATION_VAT_POST,11210906,10772028,438878,3.750000,4.555222,944646,420409,490690,70281,368597,114,TVT1,SFNFIX,NP2WZO,NP2WZO,17,1,baont,09DEC2020:14:55:57,,,
1094,2012051860,100235503,2012050001673147,31MAR2021:00:00:00,,12,4,SUBVENTION_AMORTIZATION_VAT_POST,10266260,9897663,368597,3.750000,4.555222,980070,384985,450861,65876,302721,114,TVT1,SFNFIX,NP2WZO,NP2WZO,17,1,baont,09DEC2020:14:55:57,,,
1095,2012051860,100235503,2012050001673147,30APR2021:00:00:00,,12,5,SUBVENTION_AMORTIZATION_VAT_POST,9286190,8983469,302721,3.750000,4.555222,1016823,348232,409217,60985,241736,114,TVT1,SFNFIX,NP2WZO,NP2WZO,17,1,baont,09DEC2020:14:55:57,,,
1096,2012051860,100235503,2012050001673147,31MAY2021:00:00:00,,12,6,SUBVENTION_AMORTIZATION_VAT_POST,8269367,8027631,241736,3.750000,4.555222,1054954,310101,365676,55575,186161,114,TVT1,SFNFIX,NP2WZO,NP2WZO,17,1,baont,09DEC2020:14:55:57,,,
1097,2012051860,100235503,2012050001673147,30JUN2021:00:00:00,,12,7,SUBVENTION_AMORTIZATION_VAT_POST,7214413,7028252,186161,3.750000,4.555222,1094515,270540,320152,49612,136549,114,TVT1,SFNFIX,NP2WZO,NP2WZO,17,1,baont,09DEC2020:14:55:57,,,
1098,2012051860,100235503,2012050001673147,31JUL2021:00:00:00,,12,8,SUBVENTION_AMORTIZATION_VAT_POST,6119898,5983349,136549,3.750000,4.555222,1135559,229496,272555,43059,93490,114,TVT1,SFNFIX,NP2WZO,NP2WZO,17,1,baont,09DEC2020:14:55:57,,,
1099,2012051860,100235503,2012050001673147,31AUG2021:00:00:00,,12,9,SUBVENTION_AMORTIZATION_VAT_POST,4984339,4890849,93490,3.750000,4.555222,1178142,186913,222789,35876,57614,114,TVT1,SFNFIX,NP2WZO,NP2WZO,17,1,baont,09DEC2020:14:55:57,,,
1100,2012051860,100235503,2012050001673147,30SEP2021:00:00:00,,12,10,SUBVENTION_AMORTIZATION_VAT_POST,3806197,3748583,57614,3.750000,4.555222,1222323,142732,170756,28024,29590,114,TVT1,SFNFIX,NP2WZO,NP2WZO,17,1,baont,09DEC2020:14:55:57,,,
1101,2012051860,100235503,2012050001673147,31OCT2021:00:00:00,,12,11,SUBVENTION_AMORTIZATION_VAT_POST,2583874,2554284,29590,3.750000,4.555222,1268160,96895,116353,19458,10132,114,TVT1,SFNFIX,NP2WZO,NP2WZO,17,1,baont,09DEC2020:14:55:57,,,
1102,2012051860,100235503,2012050001673147,30NOV2021:00:00:00,,12,12,SUBVENTION_AMORTIZATION_VAT_POST,1315714,1305582,10132,3.750000,4.555222,1315714,49339,59472,10132,0,114,TVT1,SFNFIX,NP2WZO,NP2WZO,17,1,baont,09DEC2020:14:55:57,,,
1103,2012051847,100235487,2012070001673193,08DEC2020:00:00:00,,12,0,DISBURSE_SUBVENTION_VAT_POST,4500000,3681818,818182,3.750000,7.362936,,,,818182,818182,24,MW1,SFNFIX,FTCDZO,FTCDZO,2,1,baont,09DEC2020:14:55:57,,,
1104,2012051847,100235487,2012070001673193,08DEC2020:00:00:00,,12,0,DISBURSE_SUBVENTION_VAT_TOTAL_POST,4500000,3681818,818182,3.750000,7.362936,,,,900000,818182,24,MW1,SFNFIX,FTCDZO,FTCDZO,2,1,baont,09DEC2020:14:55:57,,,
1105,2012051847,100235487,2012070001673193,08DEC2020:00:00:00,,12,0,DISBURSE_SUBVENTION_VAT_AMT_POST,4500000,3681818,818182,3.750000,7.362936,,,,81818,818182,24,MW1,SFNFIX,FTCDZO,FTCDZO,2,1,baont,09DEC2020:14:55:57,,,
1106,2012051847,100235487,2012070001673193,31DEC2020:00:00:00,,12,1,SUBVENTION_AMORTIZATION_VAT_POST,4500000,3681818,818182,3.750000,7.362936,303805,168750,271090,102340,715842,24,MW1,SFNFIX,FTCDZO,FTCDZO,2,1,baont,09DEC2020:14:55:57,,,
1107,2012051847,100235487,2012070001673193,31JAN2021:00:00:00,,12,2,SUBVENTION_AMORTIZATION_VAT_POST,4196195,3480353,715842,3.750000,7.362936,315198,157357,256256,98899,616943,24,MW1,SFNFIX,FTCDZO,FTCDZO,2,1,baont,09DEC2020:14:55:57,,,
1108,2012051847,100235487,2012070001673193,28FEB2021:00:00:00,,12,3,SUBVENTION_AMORTIZATION_VAT_POST,3880997,3264054,616943,3.750000,7.362936,327018,145537,240330,94793,522150,24,MW1,SFNFIX,FTCDZO,FTCDZO,2,1,baont,09DEC2020:14:55:57,,,
1599,2012142496,100235689,2012140001673341,31MAY2022:00:00:00,,24,18,SUBVENTION_AMORTIZATION_POST,9680348,9238667,441681,3.750000,5.023284,1234960,363013,464084,101071,340610,20201025085,FITIN,SFNFIX,FTCDZO,FTCDPOSTSUB1,25,1,baont,15DEC2020:09:11:39,,,14DEC2020:00:00:00
1600,2012142496,100235689,2012140001673341,30JUN2022:00:00:00,,24,19,SUBVENTION_AMORTIZATION_POST,8445388,8104778,340610,3.750000,5.023284,1281271,316702,407126,90424,250186,20201025085,FITIN,SFNFIX,FTCDZO,FTCDPOSTSUB1,25,1,baont,15DEC2020:09:11:39,,,14DEC2020:00:00:00
1601,2012142496,100235689,2012140001673341,31JUL2022:00:00:00,,24,20,SUBVENTION_AMORTIZATION_POST,7164117,6913931,250186,3.750000,5.023284,1329319,268654,347306,78652,171534,20201025085,FITIN,SFNFIX,FTCDZO,FTCDPOSTSUB1,25,1,baont,15DEC2020:09:11:39,,,14DEC2020:00:00:00
1602,2012142496,100235689,2012140001673341,31AUG2022:00:00:00,,24,21,SUBVENTION_AMORTIZATION_POST,5834798,5663264,171534,3.750000,5.023284,1379168,218805,284482,65677,105857,20201025085,FITIN,SFNFIX,FTCDZO,FTCDPOSTSUB1,25,1,baont,15DEC2020:09:11:39,,,14DEC2020:00:00:00
1603,2012142496,100235689,2012140001673341,30SEP2022:00:00:00,,24,22,SUBVENTION_AMORTIZATION_POST,4455630,4349773,105857,3.750000,5.023284,1430887,167086,218501,51415,54442,20201025085,FITIN,SFNFIX,FTCDZO,FTCDPOSTSUB1,25,1,baont,15DEC2020:09:11:39,,,14DEC2020:00:00:00
1604,2012142496,100235689,2012140001673341,31OCT2022:00:00:00,,24,23,SUBVENTION_AMORTIZATION_POST,3024743,2970301,54442,3.750000,5.023284,1484545,113428,149207,35779,18663,20201025085,FITIN,SFNFIX,FTCDZO,FTCDPOSTSUB1,25,1,baont,15DEC2020:09:11:39,,,14DEC2020:00:00:00
1605,2012142496,100235689,2012140001673341,30NOV2022:00:00:00,,24,24,SUBVENTION_AMORTIZATION_POST,1540198,1521535,18663,3.750000,5.023284,1540198,57757,76431,18663,0,20201025085,FITIN,SFNFIX,FTCDZO,FTCDPOSTSUB1,25,1,baont,15DEC2020:09:11:39,,,14DEC2020:00:00:00
1606,2012142500,100235685,2012140001673342,14DEC2020:00:00:00,,12,0,DISBURSE_SUBVENTION_VAT,38250000,34077273,4172727,3.750000,5.784360,,,,4172727,4172727,20201025083,VTL,SFNFIX,FTCDZO,FTCDPRESUB5,61,9,baont,15DEC2020:09:11:40,baont,15DEC2020:09:19:32,14DEC2020:00:00:00
1607,2012142500,100235685,2012140001673342,14DEC2020:00:00:00,,12,0,DISBURSE_SUBVENTION_VAT_TOTAL,38250000,34077273,4172727,3.750000,5.784360,,,,4590000,4172727,20201025083,VTL,SFNFIX,FTCDZO,FTCDPRESUB5,61,9,baont,15DEC2020:09:11:40,baont,15DEC2020:09:19:32,14DEC2020:00:00:00
1608,2012142500,100235685,2012140001673342,14DEC2020:00:00:00,,12,0,DISBURSE_SUBVENTION_VAT_AMT,38250000,34077273,4172727,3.750000,5.784360,,,,417273,4172727,20201025083,VTL,SFNFIX,FTCDZO,FTCDPRESUB5,61,9,baont,15DEC2020:09:11:40,baont,15DEC2020:09:19:32,14DEC2020:00:00:00
1609,2012142500,100235685,2012140001673342,31DEC2020:00:00:00,,12,1,SUBVENTION_AMORTIZATION_VAT,38250000,34077273,4172727,3.750000,5.784360,2582346,1434375,1971152,536777,3635950,20201025083,VTL,SFNFIX,FTCDZO,FTCDPRESUB5,61,1,baont,15DEC2020:09:11:40,,,14DEC2020:00:00:00
1610,2012142500,100235685,2012140001673342,31JAN2021:00:00:00,,12,2,SUBVENTION_AMORTIZATION_VAT,35667654,32031704,3635950,3.750000,5.784360,2679184,1337537,1852829,515292,3120658,20201025083,VTL,SFNFIX,FTCDZO,FTCDPRESUB5,61,1,baont,15DEC2020:09:11:40,,,14DEC2020:00:00:00
1611,2012142500,100235685,2012140001673342,28FEB2021:00:00:00,,12,3,SUBVENTION_AMORTIZATION_VAT,32988470,29867812,3120658,3.750000,5.784360,2779653,1237068,1727662,490594,2630064,20201025083,VTL,SFNFIX,FTCDZO,FTCDPRESUB5,61,1,baont,15DEC2020:09:11:40,,,14DEC2020:00:00:00
1612,2012142500,100235685,2012140001673342,31MAR2021:00:00:00,,12,4,SUBVENTION_AMORTIZATION_VAT,30208817,27578753,2630064,3.750000,5.784360,2883890,1132831,1595254,462423,2167641,20201025083,VTL,SFNFIX,FTCDZO,FTCDPRESUB5,61,1,baont,15DEC2020:09:11:40,,,14DEC2020:00:00:00
1613,2012142500,100235685,2012140001673342,30APR2021:00:00:00,,12,5,SUBVENTION_AMORTIZATION_VAT,27324927,25157286,2167641,3.750000,5.784360,2992036,1024685,1455188,430503,1737138,20201025083,VTL,SFNFIX,FTCDZO,FTCDPRESUB5,61,1,baont,15DEC2020:09:11:40,,,14DEC2020:00:00:00
1614,2012142500,100235685,2012140001673342,31MAY2021:00:00:00,,12,6,SUBVENTION_AMORTIZATION_VAT,24332891,22595753,1737138,3.750000,5.784360,3104238,912483,1307020,394537,1342601,20201025083,VTL,SFNFIX,FTCDZO,FTCDPRESUB5,61,1,baont,15DEC2020:09:11:40,,,14DEC2020:00:00:00
1615,2012142500,100235685,2012140001673342,30JUN2021:00:00:00,,12,7,SUBVENTION_AMORTIZATION_VAT,21228653,19886052,1342601,3.750000,5.784360,3220647,796074,1150281,354207,988394,20201025083,VTL,SFNFIX,FTCDZO,FTCDPRESUB5,61,1,baont,15DEC2020:09:11:40,,,14DEC2020:00:00:00
1616,2012142500,100235685,2012140001673342,31JUL2021:00:00:00,,12,8,SUBVENTION_AMORTIZATION_VAT,18008006,17019612,988394,3.750000,5.784360,3341421,675300,984476,309176,679218,20201025083,VTL,SFNFIX,FTCDZO,FTCDPRESUB5,61,1,baont,15DEC2020:09:11:40,,,14DEC2020:00:00:00
1617,2012142500,100235685,2012140001673342,31AUG2021:00:00:00,,12,9,SUBVENTION_AMORTIZATION_VAT,14666585,13987367,679218,3.750000,5.784360,3466724,549997,809080,259083,420135,20201025083,VTL,SFNFIX,FTCDZO,FTCDPRESUB5,61,1,baont,15DEC2020:09:11:40,,,14DEC2020:00:00:00
1618,2012142500,100235685,2012140001673342,30SEP2021:00:00:00,,12,10,SUBVENTION_AMORTIZATION_VAT,11199861,10779726,420135,3.750000,5.784360,3596726,419995,623538,203543,216592,20201025083,VTL,SFNFIX,FTCDZO,FTCDPRESUB5,61,1,baont,15DEC2020:09:11:40,,,14DEC2020:00:00:00
1619,2012142500,100235685,2012140001673342,31OCT2021:00:00:00,,12,11,SUBVENTION_AMORTIZATION_VAT,7603135,7386543,216592,3.750000,5.784360,3731603,285118,427264,142146,74446,20201025083,VTL,SFNFIX,FTCDZO,FTCDPRESUB5,61,1,baont,15DEC2020:09:11:40,,,14DEC2020:00:00:00
1620,2012142500,100235685,2012140001673342,30NOV2021:00:00:00,,12,12,SUBVENTION_AMORTIZATION_VAT,3871532,3797086,74446,3.750000,5.784360,3871532,145182,219637,74446,0,20201025083,VTL,SFNFIX,FTCDZO,FTCDPRESUB5,61,1,baont,15DEC2020:09:11:40,,,14DEC2020:00:00:00
1621,2012142453,100235697,2012140001673326,15DEC2020:00:00:00,,12,0,DISBURSE_SUBVENTION_VAT,8500000,7340909,1159091,3.750000,6.352567,,,,1159091,1159091,16,NK,SFNFIX,FTCDZO,FTCDPREZO2,57,99,auto,16DEC2020:09:24:53,auto,16DEC2020:09:24:53,15DEC2020:00:00:00
1622,2012142453,100235697,2012140001673326,15DEC2020:00:00:00,,12,0,DISBURSE_SUBVENTION_VAT_TOTAL,8500000,7340909,1159091,3.750000,6.352567,,,,1275000,1159091,16,NK,SFNFIX,FTCDZO,FTCDPREZO2,57,99,auto,16DEC2020:09:24:53,auto,16DEC2020:09:24:53,15DEC2020:00:00:00
1623,2012142453,100235697,2012140001673326,15DEC2020:00:00:00,,12,0,DISBURSE_SUBVENTION_VAT_AMT,8500000,7340909,1159091,3.750000,6.352567,,,,115909,1159091,16,NK,SFNFIX,FTCDZO,FTCDPREZO2,57,99,auto,16DEC2020:09:24:53,auto,16DEC2020:09:24:53,15DEC2020:00:00:00
1624,2012142453,100235697,2012140001673326,31DEC2020:00:00:00,,12,1,SUBVENTION_AMORTIZATION_VAT,8500000,7340909,1159091,3.750000,6.352567,573855,318750,466336,147586,1011505,16,NK,SFNFIX,FTCDZO,FTCDPREZO2,57,1,auto,16DEC2020:09:24:53,,,15DEC2020:00:00:00
1625,2012142453,100235697,2012140001673326,31JAN2021:00:00:00,,12,2,SUBVENTION_AMORTIZATION_VAT,7926145,6914640,1011505,3.750000,6.352567,595375,297230,439257,142027,869478,16,NK,SFNFIX,FTCDZO,FTCDPREZO2,57,1,auto,16DEC2020:09:24:53,,,15DEC2020:00:00:00
1626,2012142453,100235697,2012140001673326,28FEB2021:00:00:00,,12,3,SUBVENTION_AMORTIZATION_VAT,7330770,6461292,869478,3.750000,6.352567,617701,274904,410458,135554,733924,16,NK,SFNFIX,FTCDZO,FTCDPREZO2,57,1,auto,16DEC2020:09:24:53,,,15DEC2020:00:00:00
1627,2012142453,100235697,2012140001673326,31MAR2021:00:00:00,,12,4,SUBVENTION_AMORTIZATION_VAT,6713069,5979145,733924,3.750000,6.352567,640865,251740,379829,128089,605835,16,NK,SFNFIX,FTCDZO,FTCDPREZO2,57,1,auto,16DEC2020:09:24:53,,,15DEC2020:00:00:00
1628,2012142453,100235697,2012140001673326,30APR2021:00:00:00,,12,5,SUBVENTION_AMORTIZATION_VAT,6072204,5466369,605835,3.750000,6.352567,664897,227708,347255,119547,486288,16,NK,SFNFIX,FTCDZO,FTCDPREZO2,57,1,auto,16DEC2020:09:24:53,,,15DEC2020:00:00:00
1629,2012142453,100235697,2012140001673326,31MAY2021:00:00:00,,12,6,SUBVENTION_AMORTIZATION_VAT,5407307,4921019,486288,3.750000,6.352567,689831,202774,312611,109837,376451,16,NK,SFNFIX,FTCDZO,FTCDPREZO2,57,1,auto,16DEC2020:09:24:53,,,15DEC2020:00:00:00
1630,2012142453,100235697,2012140001673326,30JUN2021:00:00:00,,12,7,SUBVENTION_AMORTIZATION_VAT,4717476,4341025,376451,3.750000,6.352567,715700,176905,275767,98862,277589,16,NK,SFNFIX,FTCDZO,FTCDPREZO2,57,1,auto,16DEC2020:09:24:53,,,15DEC2020:00:00:00
1631,2012142453,100235697,2012140001673326,31JUL2021:00:00:00,,12,8,SUBVENTION_AMORTIZATION_VAT,4001776,3724187,277589,3.750000,6.352567,742538,150067,236581,86514,191075,16,NK,SFNFIX,FTCDZO,FTCDPREZO2,57,1,auto,16DEC2020:09:24:53,,,15DEC2020:00:00:00
1632,2012142453,100235697,2012140001673326,31AUG2021:00:00:00,,12,9,SUBVENTION_AMORTIZATION_VAT,3259238,3068163,191075,3.750000,6.352567,770384,122221,194907,72686,118389,16,NK,SFNFIX,FTCDZO,FTCDPREZO2,57,1,auto,16DEC2020:09:24:53,,,15DEC2020:00:00:00
1633,2012142453,100235697,2012140001673326,30SEP2021:00:00:00,,12,10,SUBVENTION_AMORTIZATION_VAT,2488854,2370465,118389,3.750000,6.352567,799273,93332,150585,57253,61136,16,NK,SFNFIX,FTCDZO,FTCDPREZO2,57,1,auto,16DEC2020:09:24:53,,,15DEC2020:00:00:00
1636,2012142450,100235695,2012140001673334,15DEC2020:00:00:00,,12,0,DISBURSE_SUBVENTION_POST,25000000,22000000,3000000,3.750000,6.008433,,,,3000000,3000000,20201025085,FITIN,SFNFIX,FTCDZO,FTCDPOSTSUB1,25,99,auto,16DEC2020:09:24:53,auto,16DEC2020:09:24:53,15DEC2020:00:00:00
1109,2012051847,100235487,2012070001673193,31MAR2021:00:00:00,,12,4,SUBVENTION_AMORTIZATION_VAT_POST,3553979,3031829,522150,3.750000,7.362936,339281,133274,223232,89958,432192,24,MW1,SFNFIX,FTCDZO,FTCDZO,2,1,baont,09DEC2020:14:55:57,,,
1110,2012051847,100235487,2012070001673193,30APR2021:00:00:00,,12,5,SUBVENTION_AMORTIZATION_VAT_POST,3214698,2782506,432192,3.750000,7.362936,352004,120551,204874,84323,347869,24,MW1,SFNFIX,FTCDZO,FTCDZO,2,1,baont,09DEC2020:14:55:57,,,
1111,2012051847,100235487,2012070001673193,31MAY2021:00:00:00,,12,6,SUBVENTION_AMORTIZATION_VAT_POST,2862694,2514825,347869,3.750000,7.362936,365204,107351,185165,77814,270055,24,MW1,SFNFIX,FTCDZO,FTCDZO,2,1,baont,09DEC2020:14:55:57,,,
1112,2012051847,100235487,2012070001673193,30JUN2021:00:00:00,,12,7,SUBVENTION_AMORTIZATION_VAT_POST,2497490,2227435,270055,3.750000,7.362936,378899,93656,164005,70349,199706,24,MW1,SFNFIX,FTCDZO,FTCDZO,2,1,baont,09DEC2020:14:55:57,,,
1113,2012051847,100235487,2012070001673193,31JUL2021:00:00:00,,12,8,SUBVENTION_AMORTIZATION_VAT_POST,2118591,1918885,199706,3.750000,7.362936,393108,79447,141286,61839,137867,24,MW1,SFNFIX,FTCDZO,FTCDZO,2,1,baont,09DEC2020:14:55:57,,,
1114,2012051847,100235487,2012070001673193,31AUG2021:00:00:00,,12,9,SUBVENTION_AMORTIZATION_VAT_POST,1725483,1587616,137867,3.750000,7.362936,407849,64706,116895,52189,85678,24,MW1,SFNFIX,FTCDZO,FTCDZO,2,1,baont,09DEC2020:14:55:57,,,
1115,2012051847,100235487,2012070001673193,30SEP2021:00:00:00,,12,10,SUBVENTION_AMORTIZATION_VAT_POST,1317634,1231956,85678,3.750000,7.362936,423144,49411,90708,41297,44381,24,MW1,SFNFIX,FTCDZO,FTCDZO,2,1,baont,09DEC2020:14:55:57,,,
1116,2012051847,100235487,2012070001673193,31OCT2021:00:00:00,,12,11,SUBVENTION_AMORTIZATION_VAT_POST,894490,850109,44381,3.750000,7.362936,439012,33543,62593,29050,15331,24,MW1,SFNFIX,FTCDZO,FTCDZO,2,1,baont,09DEC2020:14:55:57,,,
1117,2012051847,100235487,2012070001673193,30NOV2021:00:00:00,,12,12,SUBVENTION_AMORTIZATION_VAT_POST,455478,440147,15331,3.750000,7.362936,455478,17080,32408,15331,0,24,MW1,SFNFIX,FTCDZO,FTCDZO,2,1,baont,09DEC2020:14:55:57,,,
1118,2012051865,100235489,2012070001673192,08DEC2020:00:00:00,,12,0,DISBURSE_SUBVENTION_VAT_POST,4500000,3681818,818182,3.750000,7.362936,,,,818182,818182,24,MW1,SFNFIX,FTCDZO,FTCDZO,2,1,baont,09DEC2020:14:55:57,,,
1119,2012051865,100235489,2012070001673192,08DEC2020:00:00:00,,12,0,DISBURSE_SUBVENTION_VAT_TOTAL_POST,4500000,3681818,818182,3.750000,7.362936,,,,900000,818182,24,MW1,SFNFIX,FTCDZO,FTCDZO,2,1,baont,09DEC2020:14:55:57,,,
1120,2012051865,100235489,2012070001673192,08DEC2020:00:00:00,,12,0,DISBURSE_SUBVENTION_VAT_AMT_POST,4500000,3681818,818182,3.750000,7.362936,,,,81818,818182,24,MW1,SFNFIX,FTCDZO,FTCDZO,2,1,baont,09DEC2020:14:55:57,,,
1121,2012051865,100235489,2012070001673192,31DEC2020:00:00:00,,12,1,SUBVENTION_AMORTIZATION_VAT_POST,4500000,3681818,818182,3.750000,7.362936,303805,168750,271090,102340,715842,24,MW1,SFNFIX,FTCDZO,FTCDZO,2,1,baont,09DEC2020:14:55:57,,,
1122,2012051865,100235489,2012070001673192,31JAN2021:00:00:00,,12,2,SUBVENTION_AMORTIZATION_VAT_POST,4196195,3480353,715842,3.750000,7.362936,315198,157357,256256,98899,616943,24,MW1,SFNFIX,FTCDZO,FTCDZO,2,1,baont,09DEC2020:14:55:57,,,
1123,2012051865,100235489,2012070001673192,28FEB2021:00:00:00,,12,3,SUBVENTION_AMORTIZATION_VAT_POST,3880997,3264054,616943,3.750000,7.362936,327018,145537,240330,94793,522150,24,MW1,SFNFIX,FTCDZO,FTCDZO,2,1,baont,09DEC2020:14:55:57,,,
1124,2012051865,100235489,2012070001673192,31MAR2021:00:00:00,,12,4,SUBVENTION_AMORTIZATION_VAT_POST,3553979,3031829,522150,3.750000,7.362936,339281,133274,223232,89958,432192,24,MW1,SFNFIX,FTCDZO,FTCDZO,2,1,baont,09DEC2020:14:55:57,,,
1125,2012051865,100235489,2012070001673192,30APR2021:00:00:00,,12,5,SUBVENTION_AMORTIZATION_VAT_POST,3214698,2782506,432192,3.750000,7.362936,352004,120551,204874,84323,347869,24,MW1,SFNFIX,FTCDZO,FTCDZO,2,1,baont,09DEC2020:14:55:57,,,
1126,2012051865,100235489,2012070001673192,31MAY2021:00:00:00,,12,6,SUBVENTION_AMORTIZATION_VAT_POST,2862694,2514825,347869,3.750000,7.362936,365204,107351,185165,77814,270055,24,MW1,SFNFIX,FTCDZO,FTCDZO,2,1,baont,09DEC2020:14:55:57,,,
1127,2012051865,100235489,2012070001673192,30JUN2021:00:00:00,,12,7,SUBVENTION_AMORTIZATION_VAT_POST,2497490,2227435,270055,3.750000,7.362936,378899,93656,164005,70349,199706,24,MW1,SFNFIX,FTCDZO,FTCDZO,2,1,baont,09DEC2020:14:55:57,,,
1128,2012051865,100235489,2012070001673192,31JUL2021:00:00:00,,12,8,SUBVENTION_AMORTIZATION_VAT_POST,2118591,1918885,199706,3.750000,7.362936,393108,79447,141286,61839,137867,24,MW1,SFNFIX,FTCDZO,FTCDZO,2,1,baont,09DEC2020:14:55:57,,,
1129,2012051865,100235489,2012070001673192,31AUG2021:00:00:00,,12,9,SUBVENTION_AMORTIZATION_VAT_POST,1725483,1587616,137867,3.750000,7.362936,407849,64706,116895,52189,85678,24,MW1,SFNFIX,FTCDZO,FTCDZO,2,1,baont,09DEC2020:14:55:57,,,
1130,2012051865,100235489,2012070001673192,30SEP2021:00:00:00,,12,10,SUBVENTION_AMORTIZATION_VAT_POST,1317634,1231956,85678,3.750000,7.362936,423144,49411,90708,41297,44381,24,MW1,SFNFIX,FTCDZO,FTCDZO,2,1,baont,09DEC2020:14:55:57,,,
1131,2012051865,100235489,2012070001673192,31OCT2021:00:00:00,,12,11,SUBVENTION_AMORTIZATION_VAT_POST,894490,850109,44381,3.750000,7.362936,439012,33543,62593,29050,15331,24,MW1,SFNFIX,FTCDZO,FTCDZO,2,1,baont,09DEC2020:14:55:57,,,
1132,2012051865,100235489,2012070001673192,30NOV2021:00:00:00,,12,12,SUBVENTION_AMORTIZATION_VAT_POST,455478,440147,15331,3.750000,7.362936,455478,17080,32408,15331,0,24,MW1,SFNFIX,FTCDZO,FTCDZO,2,1,baont,09DEC2020:14:55:57,,,
993,2011301530,100235373,2011300001672525,01DEC2020:00:00:00,,12,0,DISBURSE_SUBVENTION_VAT_POST,13999000,13362682,636318,3.750000,4.555218,,,,636318,636318,115,TVT2,SFNFIX,FT2WZO,FT2WZO,23,1,baont,05DEC2020:09:57:40,,,
994,2011301530,100235373,2011300001672525,01DEC2020:00:00:00,,12,0,DISBURSE_SUBVENTION_VAT_TOTAL_POST,13999000,13362682,636318,3.750000,4.555218,,,,699950,636318,115,TVT2,SFNFIX,FT2WZO,FT2WZO,23,1,baont,05DEC2020:09:57:40,,,
995,2011301530,100235373,2011300001672525,01DEC2020:00:00:00,,12,0,DISBURSE_SUBVENTION_VAT_AMT_POST,13999000,13362682,636318,3.750000,4.555218,,,,63632,636318,115,TVT2,SFNFIX,FT2WZO,FT2WZO,23,1,baont,05DEC2020:09:57:40,,,
996,2011301530,100235373,2011300001672525,31DEC2020:00:00:00,,12,1,SUBVENTION_AMORTIZATION_VAT_POST,13999000,13362682,636318,3.750000,4.555218,945104,524963,608699,83736,552582,115,TVT2,SFNFIX,FT2WZO,FT2WZO,23,1,baont,05DEC2020:09:57:40,,,
997,2011301530,100235373,2011300001672525,31JAN2021:00:00:00,,12,2,SUBVENTION_AMORTIZATION_VAT_POST,13053896,12501314,552582,3.750000,4.555218,980546,489521,569462,79941,472641,115,TVT2,SFNFIX,FT2WZO,FT2WZO,23,1,baont,05DEC2020:09:57:40,,,
998,2011301530,100235373,2011300001672525,28FEB2021:00:00:00,,12,3,SUBVENTION_AMORTIZATION_VAT_POST,12073350,11600709,472641,3.750000,4.555218,1017316,452751,528438,75687,396954,115,TVT2,SFNFIX,FT2WZO,FT2WZO,23,1,baont,05DEC2020:09:57:40,,,
999,2011301530,100235373,2011300001672525,31MAR2021:00:00:00,,12,4,SUBVENTION_AMORTIZATION_VAT_POST,11056034,10659080,396954,3.750000,4.555218,1055466,414601,485544,70943,326011,115,TVT2,SFNFIX,FT2WZO,FT2WZO,23,1,baont,05DEC2020:09:57:40,,,
1000,2011301530,100235373,2011300001672525,30APR2021:00:00:00,,12,5,SUBVENTION_AMORTIZATION_VAT_POST,10000568,9674557,326011,3.750000,4.555218,1095046,375021,440697,65676,260335,115,TVT2,SFNFIX,FT2WZO,FT2WZO,23,1,baont,05DEC2020:09:57:40,,,
1001,2011301530,100235373,2011300001672525,31MAY2021:00:00:00,,12,6,SUBVENTION_AMORTIZATION_VAT_POST,8905522,8645187,260335,3.750000,4.555218,1136110,333957,393807,59850,200485,115,TVT2,SFNFIX,FT2WZO,FT2WZO,23,1,baont,05DEC2020:09:57:40,,,
1002,2011301530,100235373,2011300001672525,30JUN2021:00:00:00,,12,7,SUBVENTION_AMORTIZATION_VAT_POST,7769412,7568927,200485,3.750000,4.555218,1178714,291353,344781,53428,147057,115,TVT2,SFNFIX,FT2WZO,FT2WZO,23,1,baont,05DEC2020:09:57:40,,,
1003,2011301530,100235373,2011300001672525,31JUL2021:00:00:00,,12,8,SUBVENTION_AMORTIZATION_VAT_POST,6590698,6443641,147057,3.750000,4.555218,1222916,247151,293522,46371,100686,115,TVT2,SFNFIX,FT2WZO,FT2WZO,23,1,baont,05DEC2020:09:57:40,,,
1004,2011301530,100235373,2011300001672525,31AUG2021:00:00:00,,12,9,SUBVENTION_AMORTIZATION_VAT_POST,5367782,5267096,100686,3.750000,4.555218,1268775,201292,239928,38636,62050,115,TVT2,SFNFIX,FT2WZO,FT2WZO,23,1,baont,05DEC2020:09:57:40,,,
1005,2011301530,100235373,2011300001672525,30SEP2021:00:00:00,,12,10,SUBVENTION_AMORTIZATION_VAT_POST,4099007,4036957,62050,3.750000,4.555218,1316354,153713,183892,30179,31871,115,TVT2,SFNFIX,FT2WZO,FT2WZO,23,1,baont,05DEC2020:09:57:40,,,
1006,2011301530,100235373,2011300001672525,31OCT2021:00:00:00,,12,11,SUBVENTION_AMORTIZATION_VAT_POST,2782653,2750782,31871,3.750000,4.555218,1365718,104349,125304,20955,10916,115,TVT2,SFNFIX,FT2WZO,FT2WZO,23,1,baont,05DEC2020:09:57:40,,,
1007,2011301530,100235373,2011300001672525,30NOV2021:00:00:00,,12,12,SUBVENTION_AMORTIZATION_VAT_POST,1416935,1406019,10916,3.750000,4.555218,1416935,53135,64047,10916,0,115,TVT2,SFNFIX,FT2WZO,FT2WZO,23,1,baont,05DEC2020:09:57:40,,,
1008,2011301529,100235375,2011300001672526,01DEC2020:00:00:00,,24,0,DISBURSE_SUBVENTION_VAT,18000000,15545455,2454545,3.750000,5.217431,,,,2454545,2454545,114,TVT1,SFNFIX,FT2WZO,FT2WZO,21,1,baont,05DEC2020:09:57:40,,,
1009,2011301529,100235375,2011300001672526,01DEC2020:00:00:00,,24,0,DISBURSE_SUBVENTION_VAT_TOTAL,18000000,15545455,2454545,3.750000,5.217431,,,,2700000,2454545,114,TVT1,SFNFIX,FT2WZO,FT2WZO,21,1,baont,05DEC2020:09:57:40,,,
1010,2011301529,100235375,2011300001672526,01DEC2020:00:00:00,,24,0,DISBURSE_SUBVENTION_VAT_AMT,18000000,15545455,2454545,3.750000,5.217431,,,,245455,2454545,114,TVT1,SFNFIX,FT2WZO,FT2WZO,21,1,baont,05DEC2020:09:57:40,,,
1011,2011301529,100235375,2011300001672526,31DEC2020:00:00:00,,24,1,SUBVENTION_AMORTIZATION_VAT,18000000,15545455,2454545,3.750000,5.217431,475540,675000,811073,136073,2318472,114,TVT1,SFNFIX,FT2WZO,FT2WZO,21,1,baont,05DEC2020:09:57:40,,,
1012,2011301529,100235375,2011300001672526,31JAN2021:00:00:00,,24,2,SUBVENTION_AMORTIZATION_VAT,17524460,15205988,2318472,3.750000,5.217431,493373,657167,793362,136195,2182277,114,TVT1,SFNFIX,FT2WZO,FT2WZO,21,1,baont,05DEC2020:09:57:40,,,
1013,2011301529,100235375,2011300001672526,28FEB2021:00:00:00,,24,3,SUBVENTION_AMORTIZATION_VAT,17031087,14848810,2182277,3.750000,5.217431,511874,638666,774726,136060,2046217,114,TVT1,SFNFIX,FT2WZO,FT2WZO,21,1,baont,05DEC2020:09:57:40,,,
1014,2011301529,100235375,2011300001672526,31MAR2021:00:00:00,,24,4,SUBVENTION_AMORTIZATION_VAT,16519213,14472996,2046217,3.750000,5.217431,531070,619470,755119,135649,1910568,114,TVT1,SFNFIX,FT2WZO,FT2WZO,21,1,baont,05DEC2020:09:57:40,,,
1015,2011301529,100235375,2011300001672526,30APR2021:00:00:00,,24,5,SUBVENTION_AMORTIZATION_VAT,15988143,14077575,1910568,3.750000,5.217431,550985,599555,734488,134933,1775635,114,TVT1,SFNFIX,FT2WZO,FT2WZO,21,1,baont,05DEC2020:09:57:40,,,
1016,2011301529,100235375,2011300001672526,31MAY2021:00:00:00,,24,6,SUBVENTION_AMORTIZATION_VAT,15437158,13661523,1775635,3.750000,5.217431,571647,578893,712781,133888,1641747,114,TVT1,SFNFIX,FT2WZO,FT2WZO,21,1,baont,05DEC2020:09:57:40,,,
1017,2011301529,100235375,2011300001672526,30JUN2021:00:00:00,,24,7,SUBVENTION_AMORTIZATION_VAT,14865511,13223764,1641747,3.750000,5.217431,593083,557457,689941,132484,1509263,114,TVT1,SFNFIX,FT2WZO,FT2WZO,21,1,baont,05DEC2020:09:57:40,,,
1018,2011301529,100235375,2011300001672526,31JUL2021:00:00:00,,24,8,SUBVENTION_AMORTIZATION_VAT,14272428,12763165,1509263,3.750000,5.217431,615324,535216,665909,130693,1378570,114,TVT1,SFNFIX,FT2WZO,FT2WZO,21,1,baont,05DEC2020:09:57:40,,,
1019,2011301529,100235375,2011300001672526,31AUG2021:00:00:00,,24,9,SUBVENTION_AMORTIZATION_VAT,13657104,12278534,1378570,3.750000,5.217431,638399,512141,640624,128483,1250087,114,TVT1,SFNFIX,FT2WZO,FT2WZO,21,1,baont,05DEC2020:09:57:40,,,
1020,2011301529,100235375,2011300001672526,30SEP2021:00:00:00,,24,10,SUBVENTION_AMORTIZATION_VAT,13018705,11768618,1250087,3.750000,5.217431,662339,488201,614020,125819,1124268,114,TVT1,SFNFIX,FT2WZO,FT2WZO,21,1,baont,05DEC2020:09:57:40,,,
1021,2011301529,100235375,2011300001672526,31OCT2021:00:00:00,,24,11,SUBVENTION_AMORTIZATION_VAT,12356366,11232098,1124268,3.750000,5.217431,687176,463364,586027,122663,1001605,114,TVT1,SFNFIX,FT2WZO,FT2WZO,21,1,baont,05DEC2020:09:57:40,,,
1022,2011301529,100235375,2011300001672526,30NOV2021:00:00:00,,24,12,SUBVENTION_AMORTIZATION_VAT,11669190,10667585,1001605,3.750000,5.217431,712945,437595,556574,118979,882626,114,TVT1,SFNFIX,FT2WZO,FT2WZO,21,1,baont,05DEC2020:09:57:40,,,
1023,2011301529,100235375,2011300001672526,31DEC2021:00:00:00,,24,13,SUBVENTION_AMORTIZATION_VAT,10956245,10073619,882626,3.750000,5.217431,739681,410859,525584,114725,767901,114,TVT1,SFNFIX,FT2WZO,FT2WZO,21,1,baont,05DEC2020:09:57:40,,,
1024,2011301529,100235375,2011300001672526,31JAN2022:00:00:00,,24,14,SUBVENTION_AMORTIZATION_VAT,10216564,9448663,767901,3.750000,5.217431,767419,383121,492977,109856,658045,114,TVT1,SFNFIX,FT2WZO,FT2WZO,21,1,baont,05DEC2020:09:57:40,,,
1025,2011301529,100235375,2011300001672526,28FEB2022:00:00:00,,24,15,SUBVENTION_AMORTIZATION_VAT,9449145,8791100,658045,3.750000,5.217431,796197,354343,458670,104327,553718,114,TVT1,SFNFIX,FT2WZO,FT2WZO,21,1,baont,05DEC2020:09:57:40,,,
1026,2011301529,100235375,2011300001672526,31MAR2022:00:00:00,,24,16,SUBVENTION_AMORTIZATION_VAT,8652948,8099230,553718,3.750000,5.217431,826054,324486,422572,98086,455632,114,TVT1,SFNFIX,FT2WZO,FT2WZO,21,1,baont,05DEC2020:09:57:40,,,
1027,2011301529,100235375,2011300001672526,30APR2022:00:00:00,,24,17,SUBVENTION_AMORTIZATION_VAT,7826894,7371262,455632,3.750000,5.217431,857031,293509,384591,91082,364550,114,TVT1,SFNFIX,FT2WZO,FT2WZO,21,1,baont,05DEC2020:09:57:40,,,
1028,2011301529,100235375,2011300001672526,31MAY2022:00:00:00,,24,18,SUBVENTION_AMORTIZATION_VAT,6969863,6605313,364550,3.750000,5.217431,889170,261370,344628,83258,281292,114,TVT1,SFNFIX,FT2WZO,FT2WZO,21,1,baont,05DEC2020:09:57:40,,,
1029,2011301529,100235375,2011300001672526,30JUN2022:00:00:00,,24,19,SUBVENTION_AMORTIZATION_VAT,6080693,5799401,281292,3.750000,5.217431,922514,228026,302580,74554,206738,114,TVT1,SFNFIX,FT2WZO,FT2WZO,21,1,baont,05DEC2020:09:57:40,,,
1030,2011301529,100235375,2011300001672526,31JUL2022:00:00:00,,24,20,SUBVENTION_AMORTIZATION_VAT,5158179,4951441,206738,3.750000,5.217431,957108,193432,258338,64906,141832,114,TVT1,SFNFIX,FT2WZO,FT2WZO,21,1,baont,05DEC2020:09:57:40,,,
1031,2011301529,100235375,2011300001672526,31AUG2022:00:00:00,,24,21,SUBVENTION_AMORTIZATION_VAT,4201071,4059239,141832,3.750000,5.217431,993000,157540,211788,54248,87584,114,TVT1,SFNFIX,FT2WZO,FT2WZO,21,1,baont,05DEC2020:09:57:40,,,
1032,2011301529,100235375,2011300001672526,30SEP2022:00:00:00,,24,22,SUBVENTION_AMORTIZATION_VAT,3208071,3120487,87584,3.750000,5.217431,1030237,120303,162809,42506,45078,114,TVT1,SFNFIX,FT2WZO,FT2WZO,21,1,baont,05DEC2020:09:57:40,,,
1033,2011301529,100235375,2011300001672526,31OCT2022:00:00:00,,24,23,SUBVENTION_AMORTIZATION_VAT,2177834,2132756,45078,3.750000,5.217431,1068871,81669,111275,29606,15472,114,TVT1,SFNFIX,FT2WZO,FT2WZO,21,1,baont,05DEC2020:09:57:40,,,
1034,2011301529,100235375,2011300001672526,30NOV2022:00:00:00,,24,24,SUBVENTION_AMORTIZATION_VAT,1108963,1093491,15472,3.750000,5.217431,1108963,41586,57052,15472,0,114,TVT1,SFNFIX,FT2WZO,FT2WZO,21,1,baont,05DEC2020:09:57:40,,,
1036,2012051858,100235495,2012050001673145,08DEC2020:00:00:00,,21,0,DISBURSE_SUBVENTION,40000000,35200000,4800000,3.750000,5.166936,,,,4800000,4800000,20201025077,ILA1,SFNFIX,NPCDZO,NPCDZO,38,1,baont,09DEC2020:14:55:57,,,
1037,2012051858,100235495,2012050001673145,31DEC2020:00:00:00,,21,1,SUBVENTION_AMORTIZATION,40000000,35200000,4800000,3.750000,5.166936,1285945,1500000,1818761,318761,4481239,20201025077,ILA1,SFNFIX,NPCDZO,NPCDZO,38,1,baont,09DEC2020:14:55:57,,,
1038,2012051858,100235495,2012050001673145,31JAN2021:00:00:00,,21,2,SUBVENTION_AMORTIZATION,38714055,34232816,4481239,3.750000,5.166936,1334168,1451777,1768788,317011,4164228,20201025077,ILA1,SFNFIX,NPCDZO,NPCDZO,38,1,baont,09DEC2020:14:55:57,,,
1039,2012051858,100235495,2012050001673145,28FEB2021:00:00:00,,21,3,SUBVENTION_AMORTIZATION,37379887,33215659,4164228,3.750000,5.166936,1384199,1401746,1716232,314486,3849742,20201025077,ILA1,SFNFIX,NPCDZO,NPCDZO,38,1,baont,09DEC2020:14:55:57,,,
1040,2012051858,100235495,2012050001673145,31MAR2021:00:00:00,,21,4,SUBVENTION_AMORTIZATION,35995688,32145946,3849742,3.750000,5.166936,1436107,1349838,1660960,311122,3538620,20201025077,ILA1,SFNFIX,NPCDZO,NPCDZO,38,1,baont,09DEC2020:14:55:57,,,
1041,2012051858,100235495,2012050001673145,30APR2021:00:00:00,,21,5,SUBVENTION_AMORTIZATION,34559581,31020961,3538620,3.750000,5.166936,1489961,1295984,1602833,306849,3231771,20201025077,ILA1,SFNFIX,NPCDZO,NPCDZO,38,1,baont,09DEC2020:14:55:57,,,
1042,2012051858,100235495,2012050001673145,31MAY2021:00:00:00,,21,6,SUBVENTION_AMORTIZATION,33069620,29837849,3231771,3.750000,5.166936,1545834,1240111,1541703,301592,2930179,20201025077,ILA1,SFNFIX,NPCDZO,NPCDZO,38,1,baont,09DEC2020:14:55:57,,,
1043,2012051858,100235495,2012050001673145,30JUN2021:00:00:00,,21,7,SUBVENTION_AMORTIZATION,31523786,28593607,2930179,3.750000,5.166936,1603803,1182142,1477413,295271,2634908,20201025077,ILA1,SFNFIX,NPCDZO,NPCDZO,38,1,baont,09DEC2020:14:55:57,,,
1044,2012051858,100235495,2012050001673145,31JUL2021:00:00:00,,21,8,SUBVENTION_AMORTIZATION,29919983,27285075,2634908,3.750000,5.166936,1663946,1121999,1409802,287803,2347105,20201025077,ILA1,SFNFIX,NPCDZO,NPCDZO,38,1,baont,09DEC2020:14:55:57,,,
1045,2012051858,100235495,2012050001673145,31AUG2021:00:00:00,,21,9,SUBVENTION_AMORTIZATION,28256037,25908932,2347105,3.750000,5.166936,1726344,1059601,1338698,279097,2068008,20201025077,ILA1,SFNFIX,NPCDZO,NPCDZO,38,1,baont,09DEC2020:14:55:57,,,
1046,2012051858,100235495,2012050001673145,30SEP2021:00:00:00,,21,10,SUBVENTION_AMORTIZATION,26529693,24461685,2068008,3.750000,5.166936,1791082,994863,1263920,269057,1798951,20201025077,ILA1,SFNFIX,NPCDZO,NPCDZO,38,1,baont,09DEC2020:14:55:57,,,
1047,2012051858,100235495,2012050001673145,31OCT2021:00:00:00,,21,11,SUBVENTION_AMORTIZATION,24738611,22939660,1798951,3.750000,5.166936,1858247,927698,1185278,257580,1541371,20201025077,ILA1,SFNFIX,NPCDZO,NPCDZO,38,1,baont,09DEC2020:14:55:57,,,
1048,2012051858,100235495,2012050001673145,30NOV2021:00:00:00,,21,12,SUBVENTION_AMORTIZATION,22880364,21338993,1541371,3.750000,5.166936,1927931,858014,1102572,244558,1296813,20201025077,ILA1,SFNFIX,NPCDZO,NPCDZO,38,1,baont,09DEC2020:14:55:57,,,
1049,2012051858,100235495,2012050001673145,31DEC2021:00:00:00,,21,13,SUBVENTION_AMORTIZATION,20952433,19655620,1296813,3.750000,5.166936,2000229,785716,1015593,229877,1066936,20201025077,ILA1,SFNFIX,NPCDZO,NPCDZO,38,1,baont,09DEC2020:14:55:57,,,
1050,2012051858,100235495,2012050001673145,31JAN2022:00:00:00,,21,14,SUBVENTION_AMORTIZATION,18952204,17885268,1066936,3.750000,5.166936,2075237,710708,924120,213412,853524,20201025077,ILA1,SFNFIX,NPCDZO,NPCDZO,38,1,baont,09DEC2020:14:55:57,,,
1051,2012051858,100235495,2012050001673145,28FEB2022:00:00:00,,21,15,SUBVENTION_AMORTIZATION,16876967,16023443,853524,3.750000,5.166936,2153059,632886,827921,195035,658489,20201025077,ILA1,SFNFIX,NPCDZO,NPCDZO,38,1,baont,09DEC2020:14:55:57,,,
1052,2012051858,100235495,2012050001673145,31MAR2022:00:00:00,,21,16,SUBVENTION_AMORTIZATION,14723908,14065419,658489,3.750000,5.166936,2233798,552147,726751,174604,483885,20201025077,ILA1,SFNFIX,NPCDZO,NPCDZO,38,1,baont,09DEC2020:14:55:57,,,
1053,2012051858,100235495,2012050001673145,30APR2022:00:00:00,,21,17,SUBVENTION_AMORTIZATION,12490110,12006225,483885,3.750000,5.166936,2317566,468379,620354,151975,331910,20201025077,ILA1,SFNFIX,NPCDZO,NPCDZO,38,1,baont,09DEC2020:14:55:57,,,
1054,2012051858,100235495,2012050001673145,31MAY2022:00:00:00,,21,18,SUBVENTION_AMORTIZATION,10172544,9840634,331910,3.750000,5.166936,2404475,381470,508459,126989,204921,20201025077,ILA1,SFNFIX,NPCDZO,NPCDZO,38,1,baont,09DEC2020:14:55:57,,,
1055,2012051858,100235495,2012050001673145,30JUN2022:00:00:00,,21,19,SUBVENTION_AMORTIZATION,7768069,7563148,204921,3.750000,5.166936,2494642,291303,390783,99480,105441,20201025077,ILA1,SFNFIX,NPCDZO,NPCDZO,38,1,baont,09DEC2020:14:55:57,,,
1056,2012051858,100235495,2012050001673145,31JUL2022:00:00:00,,21,20,SUBVENTION_AMORTIZATION,5273427,5167986,105441,3.750000,5.166936,2588191,197754,267027,69273,36168,20201025077,ILA1,SFNFIX,NPCDZO,NPCDZO,38,1,baont,09DEC2020:14:55:57,,,
1057,2012051858,100235495,2012050001673145,31AUG2022:00:00:00,,21,21,SUBVENTION_AMORTIZATION,2685236,2649068,36168,3.750000,5.166936,2685236,100696,136876,36168,0,20201025077,ILA1,SFNFIX,NPCDZO,NPCDZO,38,1,baont,09DEC2020:14:55:57,,,
1058,2012051864,100235483,2012070001673195,08DEC2020:00:00:00,,12,0,DISBURSE_SUBVENTION_VAT_POST,11890000,11349545,540455,3.750000,4.555218,,,,540455,540455,114,TVT1,SFNFIX,FT2WZO,FT2WZO,17,1,baont,09DEC2020:14:55:57,,,
1059,2012051864,100235483,2012070001673195,08DEC2020:00:00:00,,12,0,DISBURSE_SUBVENTION_VAT_TOTAL_POST,11890000,11349545,540455,3.750000,4.555218,,,,594500,540455,114,TVT1,SFNFIX,FT2WZO,FT2WZO,17,1,baont,09DEC2020:14:55:57,,,
1060,2012051864,100235483,2012070001673195,08DEC2020:00:00:00,,12,0,DISBURSE_SUBVENTION_VAT_AMT_POST,11890000,11349545,540455,3.750000,4.555218,,,,54045,540455,114,TVT1,SFNFIX,FT2WZO,FT2WZO,17,1,baont,09DEC2020:14:55:57,,,
1061,2012051864,100235483,2012070001673195,31DEC2020:00:00:00,,12,1,SUBVENTION_AMORTIZATION_VAT_POST,11890000,11349545,540455,3.750000,4.555218,802721,445875,516997,71122,469333,114,TVT1,SFNFIX,FT2WZO,FT2WZO,17,1,baont,09DEC2020:14:55:57,,,
1062,2012051864,100235483,2012070001673195,31JAN2021:00:00:00,,12,2,SUBVENTION_AMORTIZATION_VAT_POST,11087279,10617946,469333,3.750000,4.555218,832823,415773,483671,67898,401435,114,TVT1,SFNFIX,FT2WZO,FT2WZO,17,1,baont,09DEC2020:14:55:57,,,
1063,2012051864,100235483,2012070001673195,28FEB2021:00:00:00,,12,3,SUBVENTION_AMORTIZATION_VAT_POST,10254456,9853021,401435,3.750000,4.555218,864054,384542,448827,64285,337150,114,TVT1,SFNFIX,FT2WZO,FT2WZO,17,1,baont,09DEC2020:14:55:57,,,
1064,2012051864,100235483,2012070001673195,31MAR2021:00:00:00,,12,4,SUBVENTION_AMORTIZATION_VAT_POST,9390402,9053252,337150,3.750000,4.555218,896456,352140,412395,60255,276895,114,TVT1,SFNFIX,FT2WZO,FT2WZO,17,1,baont,09DEC2020:14:55:57,,,
1065,2012051864,100235483,2012070001673195,30APR2021:00:00:00,,12,5,SUBVENTION_AMORTIZATION_VAT_POST,8493946,8217051,276895,3.750000,4.555218,930073,318523,374305,55782,221113,114,TVT1,SFNFIX,FT2WZO,FT2WZO,17,1,baont,09DEC2020:14:55:57,,,
1066,2012051864,100235483,2012070001673195,31MAY2021:00:00:00,,12,6,SUBVENTION_AMORTIZATION_VAT_POST,7563873,7342760,221113,3.750000,4.555218,964951,283645,334479,50834,170279,114,TVT1,SFNFIX,FT2WZO,FT2WZO,17,1,baont,09DEC2020:14:55:57,,,
1067,2012051864,100235483,2012070001673195,30JUN2021:00:00:00,,12,7,SUBVENTION_AMORTIZATION_VAT_POST,6598922,6428643,170279,3.750000,4.555218,1001136,247460,292839,45379,124900,114,TVT1,SFNFIX,FT2WZO,FT2WZO,17,1,baont,09DEC2020:14:55:57,,,
1068,2012051864,100235483,2012070001673195,31JUL2021:00:00:00,,12,8,SUBVENTION_AMORTIZATION_VAT_POST,5597786,5472886,124900,3.750000,4.555218,1038679,209917,249302,39385,85515,114,TVT1,SFNFIX,FT2WZO,FT2WZO,17,1,baont,09DEC2020:14:55:57,,,
1069,2012051864,100235483,2012070001673195,31AUG2021:00:00:00,,12,9,SUBVENTION_AMORTIZATION_VAT_POST,4559107,4473592,85515,3.750000,4.555218,1077629,170967,203782,32815,52700,114,TVT1,SFNFIX,FT2WZO,FT2WZO,17,1,baont,09DEC2020:14:55:57,,,
1331,2012071913,100235579,2012070001673184,09DEC2020:00:00:00,,12,0,DISBURSE_SUBVENTION_VAT,10000000,6175000,3825000,3.750000,13.140864,,,,3825000,3825000,15,NK1,SFNFIX,FTCDZO,FTCDZO,27,9,baont,14DEC2020:13:43:19,baont,14DEC2020:13:51:31,09DEC2020:00:00:00
1332,2012071913,100235579,2012070001673184,09DEC2020:00:00:00,,12,0,DISBURSE_SUBVENTION_VAT_TOTAL,10000000,6175000,3825000,3.750000,13.140864,,,,4207500,3825000,15,NK1,SFNFIX,FTCDZO,FTCDZO,27,9,baont,14DEC2020:13:43:19,baont,14DEC2020:13:51:31,09DEC2020:00:00:00
1333,2012071913,100235579,2012070001673184,09DEC2020:00:00:00,,12,0,DISBURSE_SUBVENTION_VAT_AMT,10000000,6175000,3825000,3.750000,13.140864,,,,382500,3825000,15,NK1,SFNFIX,FTCDZO,FTCDZO,27,9,baont,14DEC2020:13:43:19,baont,14DEC2020:13:51:31,09DEC2020:00:00:00
1334,2012071913,100235579,2012070001673184,31DEC2020:00:00:00,,12,1,SUBVENTION_AMORTIZATION_VAT,10000000,6175000,3825000,3.750000,13.140864,675123,375000,811448,436448,3388552,15,NK1,SFNFIX,FTCDZO,FTCDZO,27,1,baont,14DEC2020:13:43:19,,,09DEC2020:00:00:00
1335,2012071913,100235579,2012070001673184,31JAN2021:00:00:00,,12,2,SUBVENTION_AMORTIZATION_VAT,9324877,5936325,3388552,3.750000,13.140864,700440,349683,780084,430401,2958151,15,NK1,SFNFIX,FTCDZO,FTCDZO,27,1,baont,14DEC2020:13:43:19,,,09DEC2020:00:00:00
1336,2012071913,100235579,2012070001673184,28FEB2021:00:00:00,,12,3,SUBVENTION_AMORTIZATION_VAT,8624437,5666286,2958151,3.750000,13.140864,726707,323416,744599,421183,2536968,15,NK1,SFNFIX,FTCDZO,FTCDZO,27,1,baont,14DEC2020:13:43:19,,,09DEC2020:00:00:00
1337,2012071913,100235579,2012070001673184,31MAR2021:00:00:00,,12,4,SUBVENTION_AMORTIZATION_VAT,7897730,5360762,2536968,3.750000,13.140864,753958,296165,704450,408285,2128683,15,NK1,SFNFIX,FTCDZO,FTCDZO,27,1,baont,14DEC2020:13:43:19,,,09DEC2020:00:00:00
1338,2012071913,100235579,2012070001673184,30APR2021:00:00:00,,12,5,SUBVENTION_AMORTIZATION_VAT,7143772,5015089,2128683,3.750000,13.140864,782232,267891,659026,391135,1737548,15,NK1,SFNFIX,FTCDZO,FTCDZO,27,1,baont,14DEC2020:13:43:19,,,09DEC2020:00:00:00
1339,2012071913,100235579,2012070001673184,31MAY2021:00:00:00,,12,6,SUBVENTION_AMORTIZATION_VAT,6361540,4623992,1737548,3.750000,13.140864,811565,238558,607633,369075,1368473,15,NK1,SFNFIX,FTCDZO,FTCDZO,27,1,baont,14DEC2020:13:43:19,,,09DEC2020:00:00:00
1340,2012071913,100235579,2012070001673184,30JUN2021:00:00:00,,12,7,SUBVENTION_AMORTIZATION_VAT,5549975,4181502,1368473,3.750000,13.140864,841999,208124,549485,341361,1027112,15,NK1,SFNFIX,FTCDZO,FTCDZO,27,1,baont,14DEC2020:13:43:19,,,09DEC2020:00:00:00
1341,2012071913,100235579,2012070001673184,31JUL2021:00:00:00,,12,8,SUBVENTION_AMORTIZATION_VAT,4707976,3680864,1027112,3.750000,13.140864,873574,176549,483697,307148,719964,15,NK1,SFNFIX,FTCDZO,FTCDZO,27,1,baont,14DEC2020:13:43:19,,,09DEC2020:00:00:00
1342,2012071913,100235579,2012070001673184,31AUG2021:00:00:00,,12,9,SUBVENTION_AMORTIZATION_VAT,3834402,3114438,719964,3.750000,13.140864,906333,143790,409264,265474,454490,15,NK1,SFNFIX,FTCDZO,FTCDZO,27,1,baont,14DEC2020:13:43:19,,,09DEC2020:00:00:00
1343,2012071913,100235579,2012070001673184,30SEP2021:00:00:00,,12,10,SUBVENTION_AMORTIZATION_VAT,2928069,2473579,454490,3.750000,13.140864,940320,109803,325050,215247,239243,15,NK1,SFNFIX,FTCDZO,FTCDZO,27,1,baont,14DEC2020:13:43:19,,,09DEC2020:00:00:00
1344,2012071913,100235579,2012070001673184,31OCT2021:00:00:00,,12,11,SUBVENTION_AMORTIZATION_VAT,1987749,1748506,239243,3.750000,13.140864,975582,74541,229769,155228,84015,15,NK1,SFNFIX,FTCDZO,FTCDZO,27,1,baont,14DEC2020:13:43:19,,,09DEC2020:00:00:00
1345,2012071913,100235579,2012070001673184,30NOV2021:00:00:00,,12,12,SUBVENTION_AMORTIZATION_VAT,1012167,928152,84015,3.750000,13.140864,1012167,37956,121967,84015,0,15,NK1,SFNFIX,FTCDZO,FTCDZO,27,1,baont,14DEC2020:13:43:19,,,09DEC2020:00:00:00
1346,2012071943,100235587,2012070001673185,09DEC2020:00:00:00,,12,0,DISBURSE_SUBVENTION_VAT_POST,10990000,10490455,499545,3.750000,4.555217,,,,499545,499545,114,TVT1,SFNFIX,FT2WZO,FT2WZO,17,9,baont,14DEC2020:13:43:20,baont,14DEC2020:13:51:31,09DEC2020:00:00:00
1347,2012071943,100235587,2012070001673185,09DEC2020:00:00:00,,12,0,DISBURSE_SUBVENTION_VAT_TOTAL_POST,10990000,10490455,499545,3.750000,4.555217,,,,549500,499545,114,TVT1,SFNFIX,FT2WZO,FT2WZO,17,9,baont,14DEC2020:13:43:20,baont,14DEC2020:13:51:31,09DEC2020:00:00:00
1348,2012071943,100235587,2012070001673185,09DEC2020:00:00:00,,12,0,DISBURSE_SUBVENTION_VAT_AMT_POST,10990000,10490455,499545,3.750000,4.555217,,,,49955,499545,114,TVT1,SFNFIX,FT2WZO,FT2WZO,17,9,baont,14DEC2020:13:43:20,baont,14DEC2020:13:51:31,09DEC2020:00:00:00
1349,2012071943,100235587,2012070001673185,31DEC2020:00:00:00,,12,1,SUBVENTION_AMORTIZATION_VAT_POST,10990000,10490455,499545,3.750000,4.555217,741960,412125,477863,65738,433807,114,TVT1,SFNFIX,FT2WZO,FT2WZO,17,1,baont,14DEC2020:13:43:20,,,09DEC2020:00:00:00
1350,2012071943,100235587,2012070001673185,31JAN2021:00:00:00,,12,2,SUBVENTION_AMORTIZATION_VAT_POST,10248040,9814233,433807,3.750000,4.555217,769783,384302,447060,62758,371049,114,TVT1,SFNFIX,FT2WZO,FT2WZO,17,1,baont,14DEC2020:13:43:20,,,09DEC2020:00:00:00
1351,2012071943,100235587,2012070001673185,28FEB2021:00:00:00,,12,3,SUBVENTION_AMORTIZATION_VAT_POST,9478257,9107208,371049,3.750000,4.555217,798650,355435,414853,59418,311631,114,TVT1,SFNFIX,FT2WZO,FT2WZO,17,1,baont,14DEC2020:13:43:20,,,09DEC2020:00:00:00
1352,2012071943,100235587,2012070001673185,31MAR2021:00:00:00,,12,4,SUBVENTION_AMORTIZATION_VAT_POST,8679607,8367976,311631,3.750000,4.555217,828600,325485,381179,55694,255937,114,TVT1,SFNFIX,FT2WZO,FT2WZO,17,1,baont,14DEC2020:13:43:20,,,09DEC2020:00:00:00
1353,2012071943,100235587,2012070001673185,30APR2021:00:00:00,,12,5,SUBVENTION_AMORTIZATION_VAT_POST,7851007,7595070,255937,3.750000,4.555217,859672,294413,345972,51559,204378,114,TVT1,SFNFIX,FT2WZO,FT2WZO,17,1,baont,14DEC2020:13:43:20,,,09DEC2020:00:00:00
1354,2012071943,100235587,2012070001673185,31MAY2021:00:00:00,,12,6,SUBVENTION_AMORTIZATION_VAT_POST,6991335,6786957,204378,3.750000,4.555217,891910,262175,309161,46986,157392,114,TVT1,SFNFIX,FT2WZO,FT2WZO,17,1,baont,14DEC2020:13:43:20,,,09DEC2020:00:00:00
1355,2012071943,100235587,2012070001673185,30JUN2021:00:00:00,,12,7,SUBVENTION_AMORTIZATION_VAT_POST,6099425,5942033,157392,3.750000,4.555217,925357,228728,270672,41944,115448,114,TVT1,SFNFIX,FT2WZO,FT2WZO,17,1,baont,14DEC2020:13:43:20,,,09DEC2020:00:00:00
1356,2012071943,100235587,2012070001673185,31JUL2021:00:00:00,,12,8,SUBVENTION_AMORTIZATION_VAT_POST,5174068,5058620,115448,3.750000,4.555217,960057,194028,230431,36403,79045,114,TVT1,SFNFIX,FT2WZO,FT2WZO,17,1,baont,14DEC2020:13:43:20,,,09DEC2020:00:00:00
1357,2012071943,100235587,2012070001673185,31AUG2021:00:00:00,,12,9,SUBVENTION_AMORTIZATION_VAT_POST,4214011,4134966,79045,3.750000,4.555217,996060,158025,188357,30332,48713,114,TVT1,SFNFIX,FT2WZO,FT2WZO,17,1,baont,14DEC2020:13:43:20,,,09DEC2020:00:00:00
1358,2012071943,100235587,2012070001673185,30SEP2021:00:00:00,,12,10,SUBVENTION_AMORTIZATION_VAT_POST,3217951,3169238,48713,3.750000,4.555217,1033412,120673,144366,23693,25020,114,TVT1,SFNFIX,FT2WZO,FT2WZO,17,1,baont,14DEC2020:13:43:20,,,09DEC2020:00:00:00
1359,2012071943,100235587,2012070001673185,31OCT2021:00:00:00,,12,11,SUBVENTION_AMORTIZATION_VAT_POST,2184539,2159519,25020,3.750000,4.555217,1072165,81920,98371,16451,8569,114,TVT1,SFNFIX,FT2WZO,FT2WZO,17,1,baont,14DEC2020:13:43:20,,,09DEC2020:00:00:00
1360,2012071943,100235587,2012070001673185,30NOV2021:00:00:00,,12,12,SUBVENTION_AMORTIZATION_VAT_POST,1112374,1103805,8569,3.750000,4.555217,1112374,41714,50281,8569,0,114,TVT1,SFNFIX,FT2WZO,FT2WZO,17,1,baont,14DEC2020:13:43:20,,,09DEC2020:00:00:00
1361,2012071903,100235523,2012080001673197,09DEC2020:00:00:00,,12,0,DISBURSE_SUBVENTION_VAT,9500000,8204545,1295455,3.750000,6.352561,,,,1295455,1295455,13,TGDD1,SFNFIX,FTCDZO,FTCDZO,45,9,baont,14DEC2020:13:43:22,baont,14DEC2020:13:51:31,09DEC2020:00:00:00
1362,2012071903,100235523,2012080001673197,09DEC2020:00:00:00,,12,0,DISBURSE_SUBVENTION_VAT_TOTAL,9500000,8204545,1295455,3.750000,6.352561,,,,1425000,1295455,13,TGDD1,SFNFIX,FTCDZO,FTCDZO,45,9,baont,14DEC2020:13:43:22,baont,14DEC2020:13:51:31,09DEC2020:00:00:00
1363,2012071903,100235523,2012080001673197,09DEC2020:00:00:00,,12,0,DISBURSE_SUBVENTION_VAT_AMT,9500000,8204545,1295455,3.750000,6.352561,,,,129545,1295455,13,TGDD1,SFNFIX,FTCDZO,FTCDZO,45,9,baont,14DEC2020:13:43:22,baont,14DEC2020:13:51:31,09DEC2020:00:00:00
1364,2012071903,100235523,2012080001673197,31DEC2020:00:00:00,,12,1,SUBVENTION_AMORTIZATION_VAT,9500000,8204545,1295455,3.750000,6.352561,641367,356250,521199,164949,1130506,13,TGDD1,SFNFIX,FTCDZO,FTCDZO,45,1,baont,14DEC2020:13:43:22,,,09DEC2020:00:00:00
1365,2012071903,100235523,2012080001673197,31JAN2021:00:00:00,,12,2,SUBVENTION_AMORTIZATION_VAT,8858633,7728127,1130506,3.750000,6.352561,665418,332199,490934,158735,971771,13,TGDD1,SFNFIX,FTCDZO,FTCDZO,45,1,baont,14DEC2020:13:43:22,,,09DEC2020:00:00:00
1366,2012071903,100235523,2012080001673197,28FEB2021:00:00:00,,12,3,SUBVENTION_AMORTIZATION_VAT,8193215,7221444,971771,3.750000,6.352561,690371,307246,458747,151501,820270,13,TGDD1,SFNFIX,FTCDZO,FTCDZO,45,1,baont,14DEC2020:13:43:22,,,09DEC2020:00:00:00
1367,2012071903,100235523,2012080001673197,31MAR2021:00:00:00,,12,4,SUBVENTION_AMORTIZATION_VAT,7502844,6682574,820270,3.750000,6.352561,716260,281357,424515,143158,677112,13,TGDD1,SFNFIX,FTCDZO,FTCDZO,45,1,baont,14DEC2020:13:43:22,,,09DEC2020:00:00:00
1368,2012071903,100235523,2012080001673197,30APR2021:00:00:00,,12,5,SUBVENTION_AMORTIZATION_VAT,6786584,6109472,677112,3.750000,6.352561,743120,254497,388108,133611,543501,13,TGDD1,SFNFIX,FTCDZO,FTCDZO,45,1,baont,14DEC2020:13:43:22,,,09DEC2020:00:00:00
1369,2012071903,100235523,2012080001673197,31MAY2021:00:00:00,,12,6,SUBVENTION_AMORTIZATION_VAT,6043464,5499963,543501,3.750000,6.352561,770987,226630,349389,122759,420742,13,TGDD1,SFNFIX,FTCDZO,FTCDZO,45,1,baont,14DEC2020:13:43:22,,,09DEC2020:00:00:00
1370,2012071903,100235523,2012080001673197,30JUN2021:00:00:00,,12,7,SUBVENTION_AMORTIZATION_VAT,5272477,4851735,420742,3.750000,6.352561,799899,197718,308209,110491,310251,13,TGDD1,SFNFIX,FTCDZO,FTCDZO,45,1,baont,14DEC2020:13:43:22,,,09DEC2020:00:00:00
1371,2012071903,100235523,2012080001673197,31JUL2021:00:00:00,,12,8,SUBVENTION_AMORTIZATION_VAT,4472578,4162327,310251,3.750000,6.352561,829895,167722,264414,96692,213559,13,TGDD1,SFNFIX,FTCDZO,FTCDZO,45,1,baont,14DEC2020:13:43:22,,,09DEC2020:00:00:00
1372,2012071903,100235523,2012080001673197,31AUG2021:00:00:00,,12,9,SUBVENTION_AMORTIZATION_VAT,3642683,3429124,213559,3.750000,6.352561,861016,136601,217837,81236,132323,13,TGDD1,SFNFIX,FTCDZO,FTCDZO,45,1,baont,14DEC2020:13:43:22,,,09DEC2020:00:00:00
1373,2012071903,100235523,2012080001673197,30SEP2021:00:00:00,,12,10,SUBVENTION_AMORTIZATION_VAT,2781667,2649344,132323,3.750000,6.352561,893304,104313,168301,63988,68335,13,TGDD1,SFNFIX,FTCDZO,FTCDZO,45,1,baont,14DEC2020:13:43:22,,,09DEC2020:00:00:00
1374,2012071903,100235523,2012080001673197,31OCT2021:00:00:00,,12,11,SUBVENTION_AMORTIZATION_VAT,1888363,1820028,68335,3.750000,6.352561,926803,70814,115618,44804,23531,13,TGDD1,SFNFIX,FTCDZO,FTCDZO,45,1,baont,14DEC2020:13:43:22,,,09DEC2020:00:00:00
1375,2012071903,100235523,2012080001673197,30NOV2021:00:00:00,,12,12,SUBVENTION_AMORTIZATION_VAT,961560,938029,23531,3.750000,6.352561,961560,36059,59589,23531,0,13,TGDD1,SFNFIX,FTCDZO,FTCDZO,45,1,baont,14DEC2020:13:43:22,,,09DEC2020:00:00:00
1376,2012071904,100235525,2012080001673198,09DEC2020:00:00:00,,12,0,DISBURSE_SUBVENTION_VAT,9000000,7772727,1227273,3.750000,6.352564,,,,1227273,1227273,25,PV,SFNFIX,FTCDZO,FTCDZO,11,9,baont,14DEC2020:13:43:23,baont,14DEC2020:13:51:31,09DEC2020:00:00:00
1377,2012071904,100235525,2012080001673198,09DEC2020:00:00:00,,12,0,DISBURSE_SUBVENTION_VAT_TOTAL,9000000,7772727,1227273,3.750000,6.352564,,,,1350000,1227273,25,PV,SFNFIX,FTCDZO,FTCDZO,11,9,baont,14DEC2020:13:43:23,baont,14DEC2020:13:51:31,09DEC2020:00:00:00
1378,2012071904,100235525,2012080001673198,09DEC2020:00:00:00,,12,0,DISBURSE_SUBVENTION_VAT_AMT,9000000,7772727,1227273,3.750000,6.352564,,,,122727,1227273,25,PV,SFNFIX,FTCDZO,FTCDZO,11,9,baont,14DEC2020:13:43:23,baont,14DEC2020:13:51:31,09DEC2020:00:00:00
1379,2012071904,100235525,2012080001673198,31DEC2020:00:00:00,,12,1,SUBVENTION_AMORTIZATION_VAT,9000000,7772727,1227273,3.750000,6.352564,607611,337500,493767,156267,1071006,25,PV,SFNFIX,FTCDZO,FTCDZO,11,1,baont,14DEC2020:13:43:23,,,09DEC2020:00:00:00
1380,2012071904,100235525,2012080001673198,31JAN2021:00:00:00,,12,2,SUBVENTION_AMORTIZATION_VAT,8392389,7321383,1071006,3.750000,6.352564,630396,314715,465096,150381,920625,25,PV,SFNFIX,FTCDZO,FTCDZO,11,1,baont,14DEC2020:13:43:23,,,09DEC2020:00:00:00
1381,2012071904,100235525,2012080001673198,28FEB2021:00:00:00,,12,3,SUBVENTION_AMORTIZATION_VAT,7761993,6841368,920625,3.750000,6.352564,654036,291075,434602,143527,777098,25,PV,SFNFIX,FTCDZO,FTCDZO,11,1,baont,14DEC2020:13:43:23,,,09DEC2020:00:00:00
1382,2012071904,100235525,2012080001673198,31MAR2021:00:00:00,,12,4,SUBVENTION_AMORTIZATION_VAT,7107957,6330859,777098,3.750000,6.352564,678563,266548,402172,135624,641474,25,PV,SFNFIX,FTCDZO,FTCDZO,11,1,baont,14DEC2020:13:43:23,,,09DEC2020:00:00:00
1383,2012071904,100235525,2012080001673198,30APR2021:00:00:00,,12,5,SUBVENTION_AMORTIZATION_VAT,6429394,5787920,641474,3.750000,6.352564,704009,241102,367681,126579,514895,25,PV,SFNFIX,FTCDZO,FTCDZO,11,1,baont,14DEC2020:13:43:23,,,09DEC2020:00:00:00
1384,2012071904,100235525,2012080001673198,31MAY2021:00:00:00,,12,6,SUBVENTION_AMORTIZATION_VAT,5725385,5210490,514895,3.750000,6.352564,730409,214702,331000,116298,398597,25,PV,SFNFIX,FTCDZO,FTCDZO,11,1,baont,14DEC2020:13:43:23,,,09DEC2020:00:00:00
1385,2012071904,100235525,2012080001673198,30JUN2021:00:00:00,,12,7,SUBVENTION_AMORTIZATION_VAT,4994976,4596379,398597,3.750000,6.352564,757799,187312,291988,104676,293921,25,PV,SFNFIX,FTCDZO,FTCDZO,11,1,baont,14DEC2020:13:43:23,,,09DEC2020:00:00:00
1386,2012071904,100235525,2012080001673198,31JUL2021:00:00:00,,12,8,SUBVENTION_AMORTIZATION_VAT,4237177,3943256,293921,3.750000,6.352564,786217,158894,250498,91604,202317,25,PV,SFNFIX,FTCDZO,FTCDZO,11,1,baont,14DEC2020:13:43:23,,,09DEC2020:00:00:00
1387,2012071904,100235525,2012080001673198,31AUG2021:00:00:00,,12,9,SUBVENTION_AMORTIZATION_VAT,3450960,3248643,202317,3.750000,6.352564,815700,129411,206372,76961,125356,25,PV,SFNFIX,FTCDZO,FTCDZO,11,1,baont,14DEC2020:13:43:23,,,09DEC2020:00:00:00
1388,2012071904,100235525,2012080001673198,30SEP2021:00:00:00,,12,10,SUBVENTION_AMORTIZATION_VAT,2635260,2509904,125356,3.750000,6.352564,846289,98822,159443,60621,64735,25,PV,SFNFIX,FTCDZO,FTCDZO,11,1,baont,14DEC2020:13:43:23,,,09DEC2020:00:00:00
1389,2012071904,100235525,2012080001673198,31OCT2021:00:00:00,,12,11,SUBVENTION_AMORTIZATION_VAT,1788971,1724236,64735,3.750000,6.352564,878025,67086,109533,42447,22288,25,PV,SFNFIX,FTCDZO,FTCDZO,11,1,baont,14DEC2020:13:43:23,,,09DEC2020:00:00:00
1390,2012071904,100235525,2012080001673198,30NOV2021:00:00:00,,12,12,SUBVENTION_AMORTIZATION_VAT,910946,888658,22288,3.750000,6.352564,910946,34160,56453,22288,0,25,PV,SFNFIX,FTCDZO,FTCDZO,11,1,baont,14DEC2020:13:43:23,,,09DEC2020:00:00:00
1391,2012071972,100235531,2012080001673228,09DEC2020:00:00:00,,12,0,DISBURSE_SUBVENTION_VAT_POST,4750000,3886364,863636,3.750000,7.362931,,,,863636,863636,24,MW1,SFNFIX,FTCDZO,FTCDZO,2,9,baont,14DEC2020:13:43:27,baont,14DEC2020:13:51:31,09DEC2020:00:00:00
1392,2012071972,100235531,2012080001673228,09DEC2020:00:00:00,,12,0,DISBURSE_SUBVENTION_VAT_TOTAL_POST,4750000,3886364,863636,3.750000,7.362931,,,,950000,863636,24,MW1,SFNFIX,FTCDZO,FTCDZO,2,9,baont,14DEC2020:13:43:27,baont,14DEC2020:13:51:31,09DEC2020:00:00:00
1393,2012071972,100235531,2012080001673228,09DEC2020:00:00:00,,12,0,DISBURSE_SUBVENTION_VAT_AMT_POST,4750000,3886364,863636,3.750000,7.362931,,,,86364,863636,24,MW1,SFNFIX,FTCDZO,FTCDZO,2,9,baont,14DEC2020:13:43:27,baont,14DEC2020:13:51:31,09DEC2020:00:00:00
1394,2012071972,100235531,2012080001673228,31DEC2020:00:00:00,14DEC2020:00:00:00,12,1,SUBVENTION_AMORTIZATION_VAT_POST,4750000,3886364,863636,3.750000,7.362931,320683,178125,286150,108025,755611,24,MW1,SFNFIX,FTCDZO,FTCDZO,2,8,baont,14DEC2020:13:43:27,baont,15DEC2020:09:19:32,09DEC2020:00:00:00
1395,2012071972,100235531,2012080001673228,31JAN2021:00:00:00,14DEC2020:00:00:00,12,2,SUBVENTION_AMORTIZATION_VAT_POST,4429317,3673706,755611,3.750000,7.362931,332709,166099,270492,104393,651218,24,MW1,SFNFIX,FTCDZO,FTCDZO,2,8,baont,14DEC2020:13:43:27,baont,15DEC2020:09:19:32,09DEC2020:00:00:00
1396,2012071972,100235531,2012080001673228,28FEB2021:00:00:00,14DEC2020:00:00:00,12,3,SUBVENTION_AMORTIZATION_VAT_POST,4096608,3445390,651218,3.750000,7.362931,345185,153623,253682,100059,551159,24,MW1,SFNFIX,FTCDZO,FTCDZO,2,8,baont,14DEC2020:13:43:27,baont,15DEC2020:09:19:32,09DEC2020:00:00:00
1397,2012071972,100235531,2012080001673228,31MAR2021:00:00:00,14DEC2020:00:00:00,12,4,SUBVENTION_AMORTIZATION_VAT_POST,3751423,3200264,551159,3.750000,7.362931,358130,140678,235633,94955,456204,24,MW1,SFNFIX,FTCDZO,FTCDZO,2,8,baont,14DEC2020:13:43:27,baont,15DEC2020:09:19:32,09DEC2020:00:00:00
1398,2012071972,100235531,2012080001673228,30APR2021:00:00:00,14DEC2020:00:00:00,12,5,SUBVENTION_AMORTIZATION_VAT_POST,3393293,2937089,456204,3.750000,7.362931,371560,127248,216256,89008,367196,24,MW1,SFNFIX,FTCDZO,FTCDZO,2,8,baont,14DEC2020:13:43:27,baont,15DEC2020:09:19:32,09DEC2020:00:00:00
1399,2012071972,100235531,2012080001673228,31MAY2021:00:00:00,14DEC2020:00:00:00,12,6,SUBVENTION_AMORTIZATION_VAT_POST,3021733,2654537,367196,3.750000,7.362931,385493,113315,195452,82137,285059,24,MW1,SFNFIX,FTCDZO,FTCDZO,2,8,baont,14DEC2020:13:43:27,baont,15DEC2020:09:19:32,09DEC2020:00:00:00
1400,2012071972,100235531,2012080001673228,30JUN2021:00:00:00,14DEC2020:00:00:00,12,7,SUBVENTION_AMORTIZATION_VAT_POST,2636240,2351181,285059,3.750000,7.362931,399949,98859,173116,74257,210802,24,MW1,SFNFIX,FTCDZO,FTCDZO,2,8,baont,14DEC2020:13:43:27,baont,15DEC2020:09:19:32,09DEC2020:00:00:00
1401,2012071972,100235531,2012080001673228,31JUL2021:00:00:00,14DEC2020:00:00:00,12,8,SUBVENTION_AMORTIZATION_VAT_POST,2236291,2025489,210802,3.750000,7.362931,414947,83861,149135,65274,145528,24,MW1,SFNFIX,FTCDZO,FTCDZO,2,8,baont,14DEC2020:13:43:27,baont,15DEC2020:09:19:32,09DEC2020:00:00:00
1402,2012071972,100235531,2012080001673228,31AUG2021:00:00:00,14DEC2020:00:00:00,12,9,SUBVENTION_AMORTIZATION_VAT_POST,1821344,1675816,145528,3.750000,7.362931,430508,68300,123389,55089,90439,24,MW1,SFNFIX,FTCDZO,FTCDZO,2,8,baont,14DEC2020:13:43:27,baont,15DEC2020:09:19:32,09DEC2020:00:00:00
1403,2012071972,100235531,2012080001673228,30SEP2021:00:00:00,14DEC2020:00:00:00,12,10,SUBVENTION_AMORTIZATION_VAT_POST,1390836,1300397,90439,3.750000,7.362931,446652,52156,95747,43591,46848,24,MW1,SFNFIX,FTCDZO,FTCDZO,2,8,baont,14DEC2020:13:43:27,baont,15DEC2020:09:19:32,09DEC2020:00:00:00
1404,2012071972,100235531,2012080001673228,31OCT2021:00:00:00,14DEC2020:00:00:00,12,11,SUBVENTION_AMORTIZATION_VAT_POST,944184,897336,46848,3.750000,7.362931,463401,35407,66070,30663,16185,24,MW1,SFNFIX,FTCDZO,FTCDZO,2,8,baont,14DEC2020:13:43:27,baont,15DEC2020:09:19:32,09DEC2020:00:00:00
1407,2012071983,100235533,2012080001673229,09DEC2020:00:00:00,,12,0,DISBURSE_SUBVENTION_VAT_TOTAL_POST,3150000,2577273,572727,3.750000,7.362962,,,,630000,572727,16,NK,SFNFIX,FTCDZO,FTCDZO,23,9,baont,14DEC2020:13:43:27,baont,14DEC2020:13:51:31,09DEC2020:00:00:00
1408,2012071983,100235533,2012080001673229,09DEC2020:00:00:00,,12,0,DISBURSE_SUBVENTION_VAT_AMT_POST,3150000,2577273,572727,3.750000,7.362962,,,,57273,572727,16,NK,SFNFIX,FTCDZO,FTCDZO,23,9,baont,14DEC2020:13:43:27,baont,14DEC2020:13:51:31,09DEC2020:00:00:00
1409,2012071983,100235533,2012080001673229,31DEC2020:00:00:00,14DEC2020:00:00:00,12,1,SUBVENTION_AMORTIZATION_VAT_POST,3150000,2577273,572727,3.750000,7.362962,212664,118125,189764,71639,501088,16,NK,SFNFIX,FTCDZO,FTCDZO,23,8,baont,14DEC2020:13:43:27,baont,15DEC2020:09:19:32,09DEC2020:00:00:00
1410,2012071983,100235533,2012080001673229,31JAN2021:00:00:00,14DEC2020:00:00:00,12,2,SUBVENTION_AMORTIZATION_VAT_POST,2937336,2436248,501088,3.750000,7.362962,220639,110150,179380,69230,431858,16,NK,SFNFIX,FTCDZO,FTCDZO,23,8,baont,14DEC2020:13:43:27,baont,15DEC2020:09:19:32,09DEC2020:00:00:00
1411,2012071983,100235533,2012080001673229,28FEB2021:00:00:00,14DEC2020:00:00:00,12,3,SUBVENTION_AMORTIZATION_VAT_POST,2716697,2284839,431858,3.750000,7.362962,228913,101876,168232,66356,365502,16,NK,SFNFIX,FTCDZO,FTCDZO,23,8,baont,14DEC2020:13:43:27,baont,15DEC2020:09:19:32,09DEC2020:00:00:00
1412,2012071983,100235533,2012080001673229,31MAR2021:00:00:00,14DEC2020:00:00:00,12,4,SUBVENTION_AMORTIZATION_VAT_POST,2487784,2122282,365502,3.750000,7.362962,237497,93292,156263,62971,302531,16,NK,SFNFIX,FTCDZO,FTCDZO,23,8,baont,14DEC2020:13:43:27,baont,15DEC2020:09:19:32,09DEC2020:00:00:00
1413,2012071983,100235533,2012080001673229,30APR2021:00:00:00,14DEC2020:00:00:00,12,5,SUBVENTION_AMORTIZATION_VAT_POST,2250287,1947756,302531,3.750000,7.362962,246403,84386,143413,59027,243504,16,NK,SFNFIX,FTCDZO,FTCDZO,23,8,baont,14DEC2020:13:43:27,baont,15DEC2020:09:19:32,09DEC2020:00:00:00
1414,2012071983,100235533,2012080001673229,31MAY2021:00:00:00,14DEC2020:00:00:00,12,6,SUBVENTION_AMORTIZATION_VAT_POST,2003884,1760380,243504,3.750000,7.362962,255643,75146,129616,54470,189034,16,NK,SFNFIX,FTCDZO,FTCDZO,23,8,baont,14DEC2020:13:43:27,baont,15DEC2020:09:19:32,09DEC2020:00:00:00
1415,2012071983,100235533,2012080001673229,30JUN2021:00:00:00,14DEC2020:00:00:00,12,7,SUBVENTION_AMORTIZATION_VAT_POST,1748241,1559207,189034,3.750000,7.362962,265230,65559,114804,49245,139789,16,NK,SFNFIX,FTCDZO,FTCDZO,23,8,baont,14DEC2020:13:43:27,baont,15DEC2020:09:19:32,09DEC2020:00:00:00
1416,2012071983,100235533,2012080001673229,31JUL2021:00:00:00,14DEC2020:00:00:00,12,8,SUBVENTION_AMORTIZATION_VAT_POST,1483011,1343222,139789,3.750000,7.362962,275176,55613,98901,43288,96501,16,NK,SFNFIX,FTCDZO,FTCDZO,23,8,baont,14DEC2020:13:43:27,baont,15DEC2020:09:19:32,09DEC2020:00:00:00
1417,2012071983,100235533,2012080001673229,31AUG2021:00:00:00,14DEC2020:00:00:00,12,9,SUBVENTION_AMORTIZATION_VAT_POST,1207835,1111334,96501,3.750000,7.362962,285495,45294,81827,36533,59968,16,NK,SFNFIX,FTCDZO,FTCDZO,23,8,baont,14DEC2020:13:43:27,baont,15DEC2020:09:19:32,09DEC2020:00:00:00
1418,2012071983,100235533,2012080001673229,30SEP2021:00:00:00,14DEC2020:00:00:00,12,10,SUBVENTION_AMORTIZATION_VAT_POST,922340,862372,59968,3.750000,7.362962,296201,34588,63496,28908,31060,16,NK,SFNFIX,FTCDZO,FTCDZO,23,8,baont,14DEC2020:13:43:27,baont,15DEC2020:09:19:32,09DEC2020:00:00:00
1405,2012071972,100235531,2012080001673228,30NOV2021:00:00:00,14DEC2020:00:00:00,12,12,SUBVENTION_AMORTIZATION_VAT_POST,480783,464598,16185,3.750000,7.362931,480783,18029,34208,16185,0,24,MW1,SFNFIX,FTCDZO,FTCDZO,2,8,baont,14DEC2020:13:43:27,baont,15DEC2020:09:19:32,09DEC2020:00:00:00
1406,2012071983,100235533,2012080001673229,09DEC2020:00:00:00,,12,0,DISBURSE_SUBVENTION_VAT_POST,3150000,2577273,572727,3.750000,7.362962,,,,572727,572727,16,NK,SFNFIX,FTCDZO,FTCDZO,23,9,baont,14DEC2020:13:43:27,baont,14DEC2020:13:51:31,09DEC2020:00:00:00
1419,2012071983,100235533,2012080001673229,31OCT2021:00:00:00,14DEC2020:00:00:00,12,11,SUBVENTION_AMORTIZATION_VAT_POST,626139,595079,31060,3.750000,7.362962,307309,23480,43815,20335,10725,16,NK,SFNFIX,FTCDZO,FTCDZO,23,8,baont,14DEC2020:13:43:27,baont,15DEC2020:09:19:32,09DEC2020:00:00:00
1420,2012071983,100235533,2012080001673229,30NOV2021:00:00:00,14DEC2020:00:00:00,12,12,SUBVENTION_AMORTIZATION_VAT_POST,318830,308105,10725,3.750000,7.362962,318830,11956,22686,10725,0,16,NK,SFNFIX,FTCDZO,FTCDZO,23,8,baont,14DEC2020:13:43:27,baont,15DEC2020:09:19:32,09DEC2020:00:00:00
1634,2012142453,100235697,2012140001673326,31OCT2021:00:00:00,,12,11,SUBVENTION_AMORTIZATION_VAT,1689581,1628445,61136,3.750000,6.352567,829246,63359,103448,40089,21047,16,NK,SFNFIX,FTCDZO,FTCDPREZO2,57,1,auto,16DEC2020:09:24:53,,,15DEC2020:00:00:00
1635,2012142453,100235697,2012140001673326,30NOV2021:00:00:00,,12,12,SUBVENTION_AMORTIZATION_VAT,860335,839288,21047,3.750000,6.352567,860335,32263,53316,21047,0,16,NK,SFNFIX,FTCDZO,FTCDPREZO2,57,1,auto,16DEC2020:09:24:53,,,15DEC2020:00:00:00
1637,2012142450,100235695,2012140001673334,31DEC2020:00:00:00,,12,1,SUBVENTION_AMORTIZATION_POST,25000000,22000000,3000000,3.750000,6.008433,1687808,937500,1321855,384355,2615645,20201025085,FITIN,SFNFIX,FTCDZO,FTCDPOSTSUB1,25,1,auto,16DEC2020:09:24:53,,,15DEC2020:00:00:00
1638,2012142450,100235695,2012140001673334,31JAN2021:00:00:00,,12,2,SUBVENTION_AMORTIZATION_POST,23312192,20696547,2615645,3.750000,6.008433,1751101,874207,1243538,369331,2246314,20201025085,FITIN,SFNFIX,FTCDZO,FTCDPOSTSUB1,25,1,auto,16DEC2020:09:24:53,,,15DEC2020:00:00:00
1639,2012142450,100235695,2012140001673334,28FEB2021:00:00:00,,12,3,SUBVENTION_AMORTIZATION_POST,21561091,19314777,2246314,3.750000,6.008433,1816767,808541,1160515,351974,1894340,20201025085,FITIN,SFNFIX,FTCDZO,FTCDPOSTSUB1,25,1,auto,16DEC2020:09:24:53,,,15DEC2020:00:00:00
1640,2012142450,100235695,2012140001673334,31MAR2021:00:00:00,,12,4,SUBVENTION_AMORTIZATION_POST,19744324,17849984,1894340,3.750000,6.008433,1884896,740412,1072504,332092,1562248,20201025085,FITIN,SFNFIX,FTCDZO,FTCDPOSTSUB1,25,1,auto,16DEC2020:09:24:53,,,15DEC2020:00:00:00
1641,2012142450,100235695,2012140001673334,30APR2021:00:00:00,,12,5,SUBVENTION_AMORTIZATION_POST,17859428,16297180,1562248,3.750000,6.008433,1955579,669729,979205,309476,1252772,20201025085,FITIN,SFNFIX,FTCDZO,FTCDPOSTSUB1,25,1,auto,16DEC2020:09:24:53,,,15DEC2020:00:00:00
1642,2012142450,100235695,2012140001673334,31MAY2021:00:00:00,,12,6,SUBVENTION_AMORTIZATION_POST,15903849,14651077,1252772,3.750000,6.008433,2028914,596394,880300,283906,968866,20201025085,FITIN,SFNFIX,FTCDZO,FTCDPOSTSUB1,25,1,auto,16DEC2020:09:24:53,,,15DEC2020:00:00:00
1643,2012142450,100235695,2012140001673334,30JUN2021:00:00:00,,12,7,SUBVENTION_AMORTIZATION_POST,13874935,12906069,968866,3.750000,6.008433,2104998,520310,775453,255143,713723,20201025085,FITIN,SFNFIX,FTCDZO,FTCDPOSTSUB1,25,1,auto,16DEC2020:09:24:53,,,15DEC2020:00:00:00
1644,2012142450,100235695,2012140001673334,31JUL2021:00:00:00,,12,8,SUBVENTION_AMORTIZATION_POST,11769937,11056214,713723,3.750000,6.008433,2183935,441373,664305,222932,490791,20201025085,FITIN,SFNFIX,FTCDZO,FTCDPOSTSUB1,25,1,auto,16DEC2020:09:24:53,,,15DEC2020:00:00:00
1645,2012142450,100235695,2012140001673334,31AUG2021:00:00:00,,12,9,SUBVENTION_AMORTIZATION_POST,9586002,9095211,490791,3.750000,6.008433,2265833,359475,546480,187005,303786,20201025085,FITIN,SFNFIX,FTCDZO,FTCDPOSTSUB1,25,1,auto,16DEC2020:09:24:53,,,15DEC2020:00:00:00
1646,2012142450,100235695,2012140001673334,30SEP2021:00:00:00,,12,10,SUBVENTION_AMORTIZATION_POST,7320169,7016383,303786,3.750000,6.008433,2350802,274506,421575,147069,156717,20201025085,FITIN,SFNFIX,FTCDZO,FTCDPOSTSUB1,25,1,auto,16DEC2020:09:24:53,,,15DEC2020:00:00:00
1647,2012142450,100235695,2012140001673334,31OCT2021:00:00:00,,12,11,SUBVENTION_AMORTIZATION_POST,4969367,4812650,156717,3.750000,6.008433,2438957,186351,289165,102814,53903,20201025085,FITIN,SFNFIX,FTCDZO,FTCDPOSTSUB1,25,1,auto,16DEC2020:09:24:53,,,15DEC2020:00:00:00
1648,2012142450,100235695,2012140001673334,30NOV2021:00:00:00,,12,12,SUBVENTION_AMORTIZATION_POST,2530410,2476507,53903,3.750000,6.008433,2530410,94890,148799,53903,0,20201025085,FITIN,SFNFIX,FTCDZO,FTCDPOSTSUB1,25,1,auto,16DEC2020:09:24:53,,,15DEC2020:00:00:00
1487,2012142498,100235691,2012140001673339,14DEC2020:00:00:00,,12,0,DISBURSE_SUBVENTION_VAT_TOTAL,8500000,7340909,1159091,3.750000,6.352567,,,,1275000,1159091,16,NK,SFNFIX,FTCDZO,FTCDPREZO2,57,9,baont,15DEC2020:09:11:25,baont,15DEC2020:09:19:32,14DEC2020:00:00:00
1488,2012142498,100235691,2012140001673339,14DEC2020:00:00:00,,12,0,DISBURSE_SUBVENTION_VAT_AMT,8500000,7340909,1159091,3.750000,6.352567,,,,115909,1159091,16,NK,SFNFIX,FTCDZO,FTCDPREZO2,57,9,baont,15DEC2020:09:11:25,baont,15DEC2020:09:19:32,14DEC2020:00:00:00
1489,2012142498,100235691,2012140001673339,31DEC2020:00:00:00,,12,1,SUBVENTION_AMORTIZATION_VAT,8500000,7340909,1159091,3.750000,6.352567,573855,318750,466336,147586,1011505,16,NK,SFNFIX,FTCDZO,FTCDPREZO2,57,1,baont,15DEC2020:09:11:25,,,14DEC2020:00:00:00
1490,2012142498,100235691,2012140001673339,31JAN2021:00:00:00,,12,2,SUBVENTION_AMORTIZATION_VAT,7926145,6914640,1011505,3.750000,6.352567,595375,297230,439257,142027,869478,16,NK,SFNFIX,FTCDZO,FTCDPREZO2,57,1,baont,15DEC2020:09:11:25,,,14DEC2020:00:00:00
1491,2012142498,100235691,2012140001673339,28FEB2021:00:00:00,,12,3,SUBVENTION_AMORTIZATION_VAT,7330770,6461292,869478,3.750000,6.352567,617701,274904,410458,135554,733924,16,NK,SFNFIX,FTCDZO,FTCDPREZO2,57,1,baont,15DEC2020:09:11:25,,,14DEC2020:00:00:00
1492,2012142498,100235691,2012140001673339,31MAR2021:00:00:00,,12,4,SUBVENTION_AMORTIZATION_VAT,6713069,5979145,733924,3.750000,6.352567,640865,251740,379829,128089,605835,16,NK,SFNFIX,FTCDZO,FTCDPREZO2,57,1,baont,15DEC2020:09:11:25,,,14DEC2020:00:00:00
1493,2012142498,100235691,2012140001673339,30APR2021:00:00:00,,12,5,SUBVENTION_AMORTIZATION_VAT,6072204,5466369,605835,3.750000,6.352567,664897,227708,347255,119547,486288,16,NK,SFNFIX,FTCDZO,FTCDPREZO2,57,1,baont,15DEC2020:09:11:25,,,14DEC2020:00:00:00
1494,2012142498,100235691,2012140001673339,31MAY2021:00:00:00,,12,6,SUBVENTION_AMORTIZATION_VAT,5407307,4921019,486288,3.750000,6.352567,689831,202774,312611,109837,376451,16,NK,SFNFIX,FTCDZO,FTCDPREZO2,57,1,baont,15DEC2020:09:11:25,,,14DEC2020:00:00:00
1495,2012142498,100235691,2012140001673339,30JUN2021:00:00:00,,12,7,SUBVENTION_AMORTIZATION_VAT,4717476,4341025,376451,3.750000,6.352567,715700,176905,275767,98862,277589,16,NK,SFNFIX,FTCDZO,FTCDPREZO2,57,1,baont,15DEC2020:09:11:25,,,14DEC2020:00:00:00
1496,2012142498,100235691,2012140001673339,31JUL2021:00:00:00,,12,8,SUBVENTION_AMORTIZATION_VAT,4001776,3724187,277589,3.750000,6.352567,742538,150067,236581,86514,191075,16,NK,SFNFIX,FTCDZO,FTCDPREZO2,57,1,baont,15DEC2020:09:11:25,,,14DEC2020:00:00:00
1461,2012142448,100235681,2012140001673333,14DEC2020:00:00:00,,24,0,DISBURSE_SUBVENTION,40000000,35200000,4800000,3.750000,5.023281,,,,4800000,4800000,20201025085,FITIN,SFNFIX,FTCDZO,FTCDPREZO6,25,9,baont,15DEC2020:09:11:14,baont,15DEC2020:09:19:32,14DEC2020:00:00:00
1462,2012142448,100235681,2012140001673333,31DEC2020:00:00:00,,24,1,SUBVENTION_AMORTIZATION,40000000,35200000,4800000,3.750000,5.023281,1056756,1500000,1768195,268195,4531805,20201025085,FITIN,SFNFIX,FTCDZO,FTCDPREZO6,25,1,baont,15DEC2020:09:11:14,,,14DEC2020:00:00:00
1463,2012142448,100235681,2012140001673333,31JAN2021:00:00:00,,24,2,SUBVENTION_AMORTIZATION,38943244,34411439,4531805,3.750000,5.023281,1096384,1460372,1728583,268211,4263594,20201025085,FITIN,SFNFIX,FTCDZO,FTCDPREZO6,25,1,baont,15DEC2020:09:11:14,,,14DEC2020:00:00:00
1464,2012142448,100235681,2012140001673333,28FEB2021:00:00:00,,24,3,SUBVENTION_AMORTIZATION,37846860,33583266,4263594,3.750000,5.023281,1137499,1419257,1686982,267725,3995869,20201025085,FITIN,SFNFIX,FTCDZO,FTCDPREZO6,25,1,baont,15DEC2020:09:11:14,,,14DEC2020:00:00:00
1465,2012142448,100235681,2012140001673333,31MAR2021:00:00:00,,24,4,SUBVENTION_AMORTIZATION,36709361,32713492,3995869,3.750000,5.023281,1180155,1376601,1643291,266690,3729179,20201025085,FITIN,SFNFIX,FTCDZO,FTCDPREZO6,25,1,baont,15DEC2020:09:11:14,,,14DEC2020:00:00:00
1466,2012142448,100235681,2012140001673333,30APR2021:00:00:00,,24,5,SUBVENTION_AMORTIZATION,35529206,31800027,3729179,3.750000,5.023281,1224411,1332345,1597405,265060,3464119,20201025085,FITIN,SFNFIX,FTCDZO,FTCDPREZO6,25,1,baont,15DEC2020:09:11:14,,,14DEC2020:00:00:00
1467,2012142448,100235681,2012140001673333,31MAY2021:00:00:00,,24,6,SUBVENTION_AMORTIZATION,34304795,30840676,3464119,3.750000,5.023281,1270326,1286430,1549214,262784,3201335,20201025085,FITIN,SFNFIX,FTCDZO,FTCDPREZO6,25,1,baont,15DEC2020:09:11:14,,,14DEC2020:00:00:00
1468,2012142448,100235681,2012140001673333,30JUN2021:00:00:00,,24,7,SUBVENTION_AMORTIZATION,33034469,29833134,3201335,3.750000,5.023281,1317963,1238793,1498602,259809,2941526,20201025085,FITIN,SFNFIX,FTCDZO,FTCDPREZO6,25,1,baont,15DEC2020:09:11:14,,,14DEC2020:00:00:00
1469,2012142448,100235681,2012140001673333,31JUL2021:00:00:00,,24,8,SUBVENTION_AMORTIZATION,31716506,28774980,2941526,3.750000,5.023281,1367387,1189369,1445448,256079,2685447,20201025085,FITIN,SFNFIX,FTCDZO,FTCDPREZO6,25,1,baont,15DEC2020:09:11:14,,,14DEC2020:00:00:00
1470,2012142448,100235681,2012140001673333,31AUG2021:00:00:00,,24,9,SUBVENTION_AMORTIZATION,30349119,27663672,2685447,3.750000,5.023281,1418664,1138092,1389624,251532,2433915,20201025085,FITIN,SFNFIX,FTCDZO,FTCDPREZO6,25,1,baont,15DEC2020:09:11:14,,,14DEC2020:00:00:00
1471,2012142448,100235681,2012140001673333,30SEP2021:00:00:00,,24,10,SUBVENTION_AMORTIZATION,28930455,26496540,2433915,3.750000,5.023281,1471864,1084892,1330996,246104,2187811,20201025085,FITIN,SFNFIX,FTCDZO,FTCDPREZO6,25,1,baont,15DEC2020:09:11:14,,,14DEC2020:00:00:00
1472,2012142448,100235681,2012140001673333,31OCT2021:00:00:00,,24,11,SUBVENTION_AMORTIZATION,27458591,25270780,2187811,3.750000,5.023281,1527059,1029697,1269422,239725,1948086,20201025085,FITIN,SFNFIX,FTCDZO,FTCDPREZO6,25,1,baont,15DEC2020:09:11:14,,,14DEC2020:00:00:00
1473,2012142448,100235681,2012140001673333,30NOV2021:00:00:00,,24,12,SUBVENTION_AMORTIZATION,25931532,23983446,1948086,3.750000,5.023281,1584324,972432,1204756,232324,1715762,20201025085,FITIN,SFNFIX,FTCDZO,FTCDPREZO6,25,1,baont,15DEC2020:09:11:14,,,14DEC2020:00:00:00
1474,2012142448,100235681,2012140001673333,31DEC2021:00:00:00,,24,13,SUBVENTION_AMORTIZATION,24347208,22631446,1715762,3.750000,5.023281,1643736,913020,1136841,223821,1491941,20201025085,FITIN,SFNFIX,FTCDZO,FTCDPREZO6,25,1,baont,15DEC2020:09:11:14,,,14DEC2020:00:00:00
1475,2012142448,100235681,2012140001673333,31JAN2022:00:00:00,,24,14,SUBVENTION_AMORTIZATION,22703472,21211531,1491941,3.750000,5.023281,1705376,851380,1065515,214135,1277806,20201025085,FITIN,SFNFIX,FTCDZO,FTCDPREZO6,25,1,baont,15DEC2020:09:11:14,,,14DEC2020:00:00:00
1476,2012142448,100235681,2012140001673333,28FEB2022:00:00:00,,24,15,SUBVENTION_AMORTIZATION,20998096,19720290,1277806,3.750000,5.023281,1769327,787429,990606,203177,1074629,20201025085,FITIN,SFNFIX,FTCDZO,FTCDPREZO6,25,1,baont,15DEC2020:09:11:14,,,14DEC2020:00:00:00
1477,2012142448,100235681,2012140001673333,31MAR2022:00:00:00,,24,16,SUBVENTION_AMORTIZATION,19228769,18154140,1074629,3.750000,5.023281,1835677,721079,911933,190854,883775,20201025085,FITIN,SFNFIX,FTCDZO,FTCDPREZO6,25,1,baont,15DEC2020:09:11:14,,,14DEC2020:00:00:00
1478,2012142448,100235681,2012140001673333,30APR2022:00:00:00,,24,17,SUBVENTION_AMORTIZATION,17393092,16509317,883775,3.750000,5.023281,1904515,652241,829309,177068,706707,20201025085,FITIN,SFNFIX,FTCDZO,FTCDPREZO6,25,1,baont,15DEC2020:09:11:14,,,14DEC2020:00:00:00
1479,2012142448,100235681,2012140001673333,31MAY2022:00:00:00,,24,18,SUBVENTION_AMORTIZATION,15488577,14781870,706707,3.750000,5.023281,1975934,580822,742535,161713,544994,20201025085,FITIN,SFNFIX,FTCDZO,FTCDPREZO6,25,1,baont,15DEC2020:09:11:14,,,14DEC2020:00:00:00
1480,2012142448,100235681,2012140001673333,30JUN2022:00:00:00,,24,19,SUBVENTION_AMORTIZATION,13512643,12967649,544994,3.750000,5.023281,2050032,506724,651401,144677,400317,20201025085,FITIN,SFNFIX,FTCDZO,FTCDPREZO6,25,1,baont,15DEC2020:09:11:14,,,14DEC2020:00:00:00
1481,2012142448,100235681,2012140001673333,31JUL2022:00:00:00,,24,20,SUBVENTION_AMORTIZATION,11462611,11062294,400317,3.750000,5.023281,2126908,429848,555690,125842,274475,20201025085,FITIN,SFNFIX,FTCDZO,FTCDPREZO6,25,1,baont,15DEC2020:09:11:14,,,14DEC2020:00:00:00
1482,2012142448,100235681,2012140001673333,31AUG2022:00:00:00,,24,21,SUBVENTION_AMORTIZATION,9335703,9061228,274475,3.750000,5.023281,2206667,350089,455171,105082,169393,20201025085,FITIN,SFNFIX,FTCDZO,FTCDPREZO6,25,1,baont,15DEC2020:09:11:14,,,14DEC2020:00:00:00
1483,2012142448,100235681,2012140001673333,30SEP2022:00:00:00,,24,22,SUBVENTION_AMORTIZATION,7129036,6959643,169393,3.750000,5.023281,2289417,267339,349602,82263,87130,20201025085,FITIN,SFNFIX,FTCDZO,FTCDPREZO6,25,1,baont,15DEC2020:09:11:14,,,14DEC2020:00:00:00
1484,2012142448,100235681,2012140001673333,31OCT2022:00:00:00,,24,23,SUBVENTION_AMORTIZATION,4839619,4752489,87130,3.750000,5.023281,2375270,181486,238731,57245,29885,20201025085,FITIN,SFNFIX,FTCDZO,FTCDPREZO6,25,1,baont,15DEC2020:09:11:14,,,14DEC2020:00:00:00
1485,2012142448,100235681,2012140001673333,30NOV2022:00:00:00,,24,24,SUBVENTION_AMORTIZATION,2464349,2434464,29885,3.750000,5.023281,2464349,92413,122290,29885,0,20201025085,FITIN,SFNFIX,FTCDZO,FTCDPREZO6,25,1,baont,15DEC2020:09:11:14,,,14DEC2020:00:00:00
1486,2012142498,100235691,2012140001673339,14DEC2020:00:00:00,,12,0,DISBURSE_SUBVENTION_VAT,8500000,7340909,1159091,3.750000,6.352567,,,,1159091,1159091,16,NK,SFNFIX,FTCDZO,FTCDPREZO2,57,9,baont,15DEC2020:09:11:25,baont,15DEC2020:09:19:32,14DEC2020:00:00:00
1497,2012142498,100235691,2012140001673339,31AUG2021:00:00:00,,12,9,SUBVENTION_AMORTIZATION_VAT,3259238,3068163,191075,3.750000,6.352567,770384,122221,194907,72686,118389,16,NK,SFNFIX,FTCDZO,FTCDPREZO2,57,1,baont,15DEC2020:09:11:25,,,14DEC2020:00:00:00
1498,2012142498,100235691,2012140001673339,30SEP2021:00:00:00,,12,10,SUBVENTION_AMORTIZATION_VAT,2488854,2370465,118389,3.750000,6.352567,799273,93332,150585,57253,61136,16,NK,SFNFIX,FTCDZO,FTCDPREZO2,57,1,baont,15DEC2020:09:11:25,,,14DEC2020:00:00:00
1499,2012142498,100235691,2012140001673339,31OCT2021:00:00:00,,12,11,SUBVENTION_AMORTIZATION_VAT,1689581,1628445,61136,3.750000,6.352567,829246,63359,103448,40089,21047,16,NK,SFNFIX,FTCDZO,FTCDPREZO2,57,1,baont,15DEC2020:09:11:25,,,14DEC2020:00:00:00
1500,2012142498,100235691,2012140001673339,30NOV2021:00:00:00,,12,12,SUBVENTION_AMORTIZATION_VAT,860335,839288,21047,3.750000,6.352567,860335,32263,53316,21047,0,16,NK,SFNFIX,FTCDZO,FTCDPREZO2,57,1,baont,15DEC2020:09:11:25,,,14DEC2020:00:00:00
1501,2012142446,100235679,2012140001673324,14DEC2020:00:00:00,,24,0,DISBURSE_SUBVENTION_POST,40000000,35200000,4800000,3.750000,5.023281,,,,4800000,4800000,20201025085,FITIN,SFNFIX,FTCDZO,FTCDPOSTZO7,25,9,baont,15DEC2020:09:11:35,baont,15DEC2020:09:19:32,14DEC2020:00:00:00
1502,2012142446,100235679,2012140001673324,31DEC2020:00:00:00,,24,1,SUBVENTION_AMORTIZATION_POST,40000000,35200000,4800000,3.750000,5.023281,1056756,1500000,1768195,268195,4531805,20201025085,FITIN,SFNFIX,FTCDZO,FTCDPOSTZO7,25,1,baont,15DEC2020:09:11:35,,,14DEC2020:00:00:00
1503,2012142446,100235679,2012140001673324,31JAN2021:00:00:00,,24,2,SUBVENTION_AMORTIZATION_POST,38943244,34411439,4531805,3.750000,5.023281,1096384,1460372,1728583,268211,4263594,20201025085,FITIN,SFNFIX,FTCDZO,FTCDPOSTZO7,25,1,baont,15DEC2020:09:11:35,,,14DEC2020:00:00:00
1504,2012142446,100235679,2012140001673324,28FEB2021:00:00:00,,24,3,SUBVENTION_AMORTIZATION_POST,37846860,33583266,4263594,3.750000,5.023281,1137499,1419257,1686982,267725,3995869,20201025085,FITIN,SFNFIX,FTCDZO,FTCDPOSTZO7,25,1,baont,15DEC2020:09:11:35,,,14DEC2020:00:00:00
1505,2012142446,100235679,2012140001673324,31MAR2021:00:00:00,,24,4,SUBVENTION_AMORTIZATION_POST,36709361,32713492,3995869,3.750000,5.023281,1180155,1376601,1643291,266690,3729179,20201025085,FITIN,SFNFIX,FTCDZO,FTCDPOSTZO7,25,1,baont,15DEC2020:09:11:35,,,14DEC2020:00:00:00
1506,2012142446,100235679,2012140001673324,30APR2021:00:00:00,,24,5,SUBVENTION_AMORTIZATION_POST,35529206,31800027,3729179,3.750000,5.023281,1224411,1332345,1597405,265060,3464119,20201025085,FITIN,SFNFIX,FTCDZO,FTCDPOSTZO7,25,1,baont,15DEC2020:09:11:35,,,14DEC2020:00:00:00
1507,2012142446,100235679,2012140001673324,31MAY2021:00:00:00,,24,6,SUBVENTION_AMORTIZATION_POST,34304795,30840676,3464119,3.750000,5.023281,1270326,1286430,1549214,262784,3201335,20201025085,FITIN,SFNFIX,FTCDZO,FTCDPOSTZO7,25,1,baont,15DEC2020:09:11:35,,,14DEC2020:00:00:00
1508,2012142446,100235679,2012140001673324,30JUN2021:00:00:00,,24,7,SUBVENTION_AMORTIZATION_POST,33034469,29833134,3201335,3.750000,5.023281,1317963,1238793,1498602,259809,2941526,20201025085,FITIN,SFNFIX,FTCDZO,FTCDPOSTZO7,25,1,baont,15DEC2020:09:11:35,,,14DEC2020:00:00:00
1509,2012142446,100235679,2012140001673324,31JUL2021:00:00:00,,24,8,SUBVENTION_AMORTIZATION_POST,31716506,28774980,2941526,3.750000,5.023281,1367387,1189369,1445448,256079,2685447,20201025085,FITIN,SFNFIX,FTCDZO,FTCDPOSTZO7,25,1,baont,15DEC2020:09:11:35,,,14DEC2020:00:00:00
1510,2012142446,100235679,2012140001673324,31AUG2021:00:00:00,,24,9,SUBVENTION_AMORTIZATION_POST,30349119,27663672,2685447,3.750000,5.023281,1418664,1138092,1389624,251532,2433915,20201025085,FITIN,SFNFIX,FTCDZO,FTCDPOSTZO7,25,1,baont,15DEC2020:09:11:35,,,14DEC2020:00:00:00
1511,2012142446,100235679,2012140001673324,30SEP2021:00:00:00,,24,10,SUBVENTION_AMORTIZATION_POST,28930455,26496540,2433915,3.750000,5.023281,1471864,1084892,1330996,246104,2187811,20201025085,FITIN,SFNFIX,FTCDZO,FTCDPOSTZO7,25,1,baont,15DEC2020:09:11:35,,,14DEC2020:00:00:00
1512,2012142446,100235679,2012140001673324,31OCT2021:00:00:00,,24,11,SUBVENTION_AMORTIZATION_POST,27458591,25270780,2187811,3.750000,5.023281,1527059,1029697,1269422,239725,1948086,20201025085,FITIN,SFNFIX,FTCDZO,FTCDPOSTZO7,25,1,baont,15DEC2020:09:11:35,,,14DEC2020:00:00:00
1513,2012142446,100235679,2012140001673324,30NOV2021:00:00:00,,24,12,SUBVENTION_AMORTIZATION_POST,25931532,23983446,1948086,3.750000,5.023281,1584324,972432,1204756,232324,1715762,20201025085,FITIN,SFNFIX,FTCDZO,FTCDPOSTZO7,25,1,baont,15DEC2020:09:11:35,,,14DEC2020:00:00:00
1514,2012142446,100235679,2012140001673324,31DEC2021:00:00:00,,24,13,SUBVENTION_AMORTIZATION_POST,24347208,22631446,1715762,3.750000,5.023281,1643736,913020,1136841,223821,1491941,20201025085,FITIN,SFNFIX,FTCDZO,FTCDPOSTZO7,25,1,baont,15DEC2020:09:11:35,,,14DEC2020:00:00:00
1515,2012142446,100235679,2012140001673324,31JAN2022:00:00:00,,24,14,SUBVENTION_AMORTIZATION_POST,22703472,21211531,1491941,3.750000,5.023281,1705376,851380,1065515,214135,1277806,20201025085,FITIN,SFNFIX,FTCDZO,FTCDPOSTZO7,25,1,baont,15DEC2020:09:11:35,,,14DEC2020:00:00:00
1516,2012142446,100235679,2012140001673324,28FEB2022:00:00:00,,24,15,SUBVENTION_AMORTIZATION_POST,20998096,19720290,1277806,3.750000,5.023281,1769327,787429,990606,203177,1074629,20201025085,FITIN,SFNFIX,FTCDZO,FTCDPOSTZO7,25,1,baont,15DEC2020:09:11:35,,,14DEC2020:00:00:00
1517,2012142446,100235679,2012140001673324,31MAR2022:00:00:00,,24,16,SUBVENTION_AMORTIZATION_POST,19228769,18154140,1074629,3.750000,5.023281,1835677,721079,911933,190854,883775,20201025085,FITIN,SFNFIX,FTCDZO,FTCDPOSTZO7,25,1,baont,15DEC2020:09:11:35,,,14DEC2020:00:00:00
1518,2012142446,100235679,2012140001673324,30APR2022:00:00:00,,24,17,SUBVENTION_AMORTIZATION_POST,17393092,16509317,883775,3.750000,5.023281,1904515,652241,829309,177068,706707,20201025085,FITIN,SFNFIX,FTCDZO,FTCDPOSTZO7,25,1,baont,15DEC2020:09:11:35,,,14DEC2020:00:00:00
1519,2012142446,100235679,2012140001673324,31MAY2022:00:00:00,,24,18,SUBVENTION_AMORTIZATION_POST,15488577,14781870,706707,3.750000,5.023281,1975934,580822,742535,161713,544994,20201025085,FITIN,SFNFIX,FTCDZO,FTCDPOSTZO7,25,1,baont,15DEC2020:09:11:35,,,14DEC2020:00:00:00
1520,2012142446,100235679,2012140001673324,30JUN2022:00:00:00,,24,19,SUBVENTION_AMORTIZATION_POST,13512643,12967649,544994,3.750000,5.023281,2050032,506724,651401,144677,400317,20201025085,FITIN,SFNFIX,FTCDZO,FTCDPOSTZO7,25,1,baont,15DEC2020:09:11:35,,,14DEC2020:00:00:00
1521,2012142446,100235679,2012140001673324,31JUL2022:00:00:00,,24,20,SUBVENTION_AMORTIZATION_POST,11462611,11062294,400317,3.750000,5.023281,2126908,429848,555690,125842,274475,20201025085,FITIN,SFNFIX,FTCDZO,FTCDPOSTZO7,25,1,baont,15DEC2020:09:11:35,,,14DEC2020:00:00:00
1522,2012142446,100235679,2012140001673324,31AUG2022:00:00:00,,24,21,SUBVENTION_AMORTIZATION_POST,9335703,9061228,274475,3.750000,5.023281,2206667,350089,455171,105082,169393,20201025085,FITIN,SFNFIX,FTCDZO,FTCDPOSTZO7,25,1,baont,15DEC2020:09:11:35,,,14DEC2020:00:00:00
1523,2012142446,100235679,2012140001673324,30SEP2022:00:00:00,,24,22,SUBVENTION_AMORTIZATION_POST,7129036,6959643,169393,3.750000,5.023281,2289417,267339,349602,82263,87130,20201025085,FITIN,SFNFIX,FTCDZO,FTCDPOSTZO7,25,1,baont,15DEC2020:09:11:35,,,14DEC2020:00:00:00
1524,2012142446,100235679,2012140001673324,31OCT2022:00:00:00,,24,23,SUBVENTION_AMORTIZATION_POST,4839619,4752489,87130,3.750000,5.023281,2375270,181486,238731,57245,29885,20201025085,FITIN,SFNFIX,FTCDZO,FTCDPOSTZO7,25,1,baont,15DEC2020:09:11:35,,,14DEC2020:00:00:00
1525,2012142446,100235679,2012140001673324,30NOV2022:00:00:00,,24,24,SUBVENTION_AMORTIZATION_POST,2464349,2434464,29885,3.750000,5.023281,2464349,92413,122290,29885,0,20201025085,FITIN,SFNFIX,FTCDZO,FTCDPOSTZO7,25,1,baont,15DEC2020:09:11:35,,,14DEC2020:00:00:00
1526,2012142454,100235683,2012140001673327,14DEC2020:00:00:00,,12,0,DISBURSE_SUBVENTION_VAT,38250000,34077273,4172727,3.750000,5.784360,,,,4172727,4172727,20201025083,VTL,SFNFIX,FTCDZO,FTCDPRESUB5,61,9,baont,15DEC2020:09:11:36,baont,15DEC2020:09:19:32,14DEC2020:00:00:00
1527,2012142454,100235683,2012140001673327,14DEC2020:00:00:00,,12,0,DISBURSE_SUBVENTION_VAT_TOTAL,38250000,34077273,4172727,3.750000,5.784360,,,,4590000,4172727,20201025083,VTL,SFNFIX,FTCDZO,FTCDPRESUB5,61,9,baont,15DEC2020:09:11:36,baont,15DEC2020:09:19:32,14DEC2020:00:00:00
1528,2012142454,100235683,2012140001673327,14DEC2020:00:00:00,,12,0,DISBURSE_SUBVENTION_VAT_AMT,38250000,34077273,4172727,3.750000,5.784360,,,,417273,4172727,20201025083,VTL,SFNFIX,FTCDZO,FTCDPRESUB5,61,9,baont,15DEC2020:09:11:36,baont,15DEC2020:09:19:32,14DEC2020:00:00:00
1529,2012142454,100235683,2012140001673327,31DEC2020:00:00:00,,12,1,SUBVENTION_AMORTIZATION_VAT,38250000,34077273,4172727,3.750000,5.784360,2582346,1434375,1971152,536777,3635950,20201025083,VTL,SFNFIX,FTCDZO,FTCDPRESUB5,61,1,baont,15DEC2020:09:11:36,,,14DEC2020:00:00:00
1530,2012142454,100235683,2012140001673327,31JAN2021:00:00:00,,12,2,SUBVENTION_AMORTIZATION_VAT,35667654,32031704,3635950,3.750000,5.784360,2679184,1337537,1852829,515292,3120658,20201025083,VTL,SFNFIX,FTCDZO,FTCDPRESUB5,61,1,baont,15DEC2020:09:11:36,,,14DEC2020:00:00:00
1531,2012142454,100235683,2012140001673327,28FEB2021:00:00:00,,12,3,SUBVENTION_AMORTIZATION_VAT,32988470,29867812,3120658,3.750000,5.784360,2779653,1237068,1727662,490594,2630064,20201025083,VTL,SFNFIX,FTCDZO,FTCDPRESUB5,61,1,baont,15DEC2020:09:11:36,,,14DEC2020:00:00:00
1421,2012102301,100235645,2012110001673290,11DEC2020:00:00:00,,12,0,DISBURSE_SUBVENTION_VAT,8500000,7340909,1159091,3.750000,6.352567,,,,1159091,1159091,16,NK,SFNFIX,FASTCD,FTCDPREZO2,24,9,baont,14DEC2020:15:33:34,baont,14DEC2020:15:34:27,11DEC2020:00:00:00
1422,2012102301,100235645,2012110001673290,11DEC2020:00:00:00,,12,0,DISBURSE_SUBVENTION_VAT_TOTAL,8500000,7340909,1159091,3.750000,6.352567,,,,1275000,1159091,16,NK,SFNFIX,FASTCD,FTCDPREZO2,24,9,baont,14DEC2020:15:33:34,baont,14DEC2020:15:34:27,11DEC2020:00:00:00
1423,2012102301,100235645,2012110001673290,11DEC2020:00:00:00,,12,0,DISBURSE_SUBVENTION_VAT_AMT,8500000,7340909,1159091,3.750000,6.352567,,,,115909,1159091,16,NK,SFNFIX,FASTCD,FTCDPREZO2,24,9,baont,14DEC2020:15:33:34,baont,14DEC2020:15:34:27,11DEC2020:00:00:00
1424,2012102301,100235645,2012110001673290,31DEC2020:00:00:00,,12,1,SUBVENTION_AMORTIZATION_VAT,8500000,7340909,1159091,3.750000,6.352567,573855,318750,466336,147586,1011505,16,NK,SFNFIX,FASTCD,FTCDPREZO2,24,1,baont,14DEC2020:15:33:34,,,11DEC2020:00:00:00
1425,2012102301,100235645,2012110001673290,31JAN2021:00:00:00,,12,2,SUBVENTION_AMORTIZATION_VAT,7926145,6914640,1011505,3.750000,6.352567,595375,297230,439257,142027,869478,16,NK,SFNFIX,FASTCD,FTCDPREZO2,24,1,baont,14DEC2020:15:33:34,,,11DEC2020:00:00:00
1426,2012102301,100235645,2012110001673290,28FEB2021:00:00:00,,12,3,SUBVENTION_AMORTIZATION_VAT,7330770,6461292,869478,3.750000,6.352567,617701,274904,410458,135554,733924,16,NK,SFNFIX,FASTCD,FTCDPREZO2,24,1,baont,14DEC2020:15:33:34,,,11DEC2020:00:00:00
1427,2012102301,100235645,2012110001673290,31MAR2021:00:00:00,,12,4,SUBVENTION_AMORTIZATION_VAT,6713069,5979145,733924,3.750000,6.352567,640865,251740,379829,128089,605835,16,NK,SFNFIX,FASTCD,FTCDPREZO2,24,1,baont,14DEC2020:15:33:34,,,11DEC2020:00:00:00
1428,2012102301,100235645,2012110001673290,30APR2021:00:00:00,,12,5,SUBVENTION_AMORTIZATION_VAT,6072204,5466369,605835,3.750000,6.352567,664897,227708,347255,119547,486288,16,NK,SFNFIX,FASTCD,FTCDPREZO2,24,1,baont,14DEC2020:15:33:34,,,11DEC2020:00:00:00
1429,2012102301,100235645,2012110001673290,31MAY2021:00:00:00,,12,6,SUBVENTION_AMORTIZATION_VAT,5407307,4921019,486288,3.750000,6.352567,689831,202774,312611,109837,376451,16,NK,SFNFIX,FASTCD,FTCDPREZO2,24,1,baont,14DEC2020:15:33:34,,,11DEC2020:00:00:00
1430,2012102301,100235645,2012110001673290,30JUN2021:00:00:00,,12,7,SUBVENTION_AMORTIZATION_VAT,4717476,4341025,376451,3.750000,6.352567,715700,176905,275767,98862,277589,16,NK,SFNFIX,FASTCD,FTCDPREZO2,24,1,baont,14DEC2020:15:33:34,,,11DEC2020:00:00:00
1431,2012102301,100235645,2012110001673290,31JUL2021:00:00:00,,12,8,SUBVENTION_AMORTIZATION_VAT,4001776,3724187,277589,3.750000,6.352567,742538,150067,236581,86514,191075,16,NK,SFNFIX,FASTCD,FTCDPREZO2,24,1,baont,14DEC2020:15:33:34,,,11DEC2020:00:00:00
1432,2012102301,100235645,2012110001673290,31AUG2021:00:00:00,,12,9,SUBVENTION_AMORTIZATION_VAT,3259238,3068163,191075,3.750000,6.352567,770384,122221,194907,72686,118389,16,NK,SFNFIX,FASTCD,FTCDPREZO2,24,1,baont,14DEC2020:15:33:34,,,11DEC2020:00:00:00
1433,2012102301,100235645,2012110001673290,30SEP2021:00:00:00,,12,10,SUBVENTION_AMORTIZATION_VAT,2488854,2370465,118389,3.750000,6.352567,799273,93332,150585,57253,61136,16,NK,SFNFIX,FASTCD,FTCDPREZO2,24,1,baont,14DEC2020:15:33:34,,,11DEC2020:00:00:00
1434,2012102301,100235645,2012110001673290,31OCT2021:00:00:00,,12,11,SUBVENTION_AMORTIZATION_VAT,1689581,1628445,61136,3.750000,6.352567,829246,63359,103448,40089,21047,16,NK,SFNFIX,FASTCD,FTCDPREZO2,24,1,baont,14DEC2020:15:33:34,,,11DEC2020:00:00:00
1435,2012102301,100235645,2012110001673290,30NOV2021:00:00:00,,12,12,SUBVENTION_AMORTIZATION_VAT,860335,839288,21047,3.750000,6.352567,860335,32263,53316,21047,0,16,NK,SFNFIX,FASTCD,FTCDPREZO2,24,1,baont,14DEC2020:15:33:34,,,11DEC2020:00:00:00
1436,2012102303,100235643,2012110001673291,11DEC2020:00:00:00,,24,0,DISBURSE_SUBVENTION,40000000,35200000,4800000,3.750000,5.023281,,,,4800000,4800000,117,FITIN1,SFNFIX,FASTCD,FTCDPREZO6,9,9,baont,14DEC2020:15:33:39,baont,14DEC2020:15:34:27,11DEC2020:00:00:00
1437,2012102303,100235643,2012110001673291,31DEC2020:00:00:00,,24,1,SUBVENTION_AMORTIZATION,40000000,35200000,4800000,3.750000,5.023281,1056756,1500000,1768195,268195,4531805,117,FITIN1,SFNFIX,FASTCD,FTCDPREZO6,9,1,baont,14DEC2020:15:33:39,,,11DEC2020:00:00:00
1438,2012102303,100235643,2012110001673291,31JAN2021:00:00:00,,24,2,SUBVENTION_AMORTIZATION,38943244,34411439,4531805,3.750000,5.023281,1096384,1460372,1728583,268211,4263594,117,FITIN1,SFNFIX,FASTCD,FTCDPREZO6,9,1,baont,14DEC2020:15:33:39,,,11DEC2020:00:00:00
1439,2012102303,100235643,2012110001673291,28FEB2021:00:00:00,,24,3,SUBVENTION_AMORTIZATION,37846860,33583266,4263594,3.750000,5.023281,1137499,1419257,1686982,267725,3995869,117,FITIN1,SFNFIX,FASTCD,FTCDPREZO6,9,1,baont,14DEC2020:15:33:39,,,11DEC2020:00:00:00
1440,2012102303,100235643,2012110001673291,31MAR2021:00:00:00,,24,4,SUBVENTION_AMORTIZATION,36709361,32713492,3995869,3.750000,5.023281,1180155,1376601,1643291,266690,3729179,117,FITIN1,SFNFIX,FASTCD,FTCDPREZO6,9,1,baont,14DEC2020:15:33:39,,,11DEC2020:00:00:00
1441,2012102303,100235643,2012110001673291,30APR2021:00:00:00,,24,5,SUBVENTION_AMORTIZATION,35529206,31800027,3729179,3.750000,5.023281,1224411,1332345,1597405,265060,3464119,117,FITIN1,SFNFIX,FASTCD,FTCDPREZO6,9,1,baont,14DEC2020:15:33:39,,,11DEC2020:00:00:00
1442,2012102303,100235643,2012110001673291,31MAY2021:00:00:00,,24,6,SUBVENTION_AMORTIZATION,34304795,30840676,3464119,3.750000,5.023281,1270326,1286430,1549214,262784,3201335,117,FITIN1,SFNFIX,FASTCD,FTCDPREZO6,9,1,baont,14DEC2020:15:33:39,,,11DEC2020:00:00:00
1443,2012102303,100235643,2012110001673291,30JUN2021:00:00:00,,24,7,SUBVENTION_AMORTIZATION,33034469,29833134,3201335,3.750000,5.023281,1317963,1238793,1498602,259809,2941526,117,FITIN1,SFNFIX,FASTCD,FTCDPREZO6,9,1,baont,14DEC2020:15:33:39,,,11DEC2020:00:00:00
1444,2012102303,100235643,2012110001673291,31JUL2021:00:00:00,,24,8,SUBVENTION_AMORTIZATION,31716506,28774980,2941526,3.750000,5.023281,1367387,1189369,1445448,256079,2685447,117,FITIN1,SFNFIX,FASTCD,FTCDPREZO6,9,1,baont,14DEC2020:15:33:39,,,11DEC2020:00:00:00
1445,2012102303,100235643,2012110001673291,31AUG2021:00:00:00,,24,9,SUBVENTION_AMORTIZATION,30349119,27663672,2685447,3.750000,5.023281,1418664,1138092,1389624,251532,2433915,117,FITIN1,SFNFIX,FASTCD,FTCDPREZO6,9,1,baont,14DEC2020:15:33:39,,,11DEC2020:00:00:00
1446,2012102303,100235643,2012110001673291,30SEP2021:00:00:00,,24,10,SUBVENTION_AMORTIZATION,28930455,26496540,2433915,3.750000,5.023281,1471864,1084892,1330996,246104,2187811,117,FITIN1,SFNFIX,FASTCD,FTCDPREZO6,9,1,baont,14DEC2020:15:33:39,,,11DEC2020:00:00:00
1447,2012102303,100235643,2012110001673291,31OCT2021:00:00:00,,24,11,SUBVENTION_AMORTIZATION,27458591,25270780,2187811,3.750000,5.023281,1527059,1029697,1269422,239725,1948086,117,FITIN1,SFNFIX,FASTCD,FTCDPREZO6,9,1,baont,14DEC2020:15:33:39,,,11DEC2020:00:00:00
1448,2012102303,100235643,2012110001673291,30NOV2021:00:00:00,,24,12,SUBVENTION_AMORTIZATION,25931532,23983446,1948086,3.750000,5.023281,1584324,972432,1204756,232324,1715762,117,FITIN1,SFNFIX,FASTCD,FTCDPREZO6,9,1,baont,14DEC2020:15:33:39,,,11DEC2020:00:00:00
1449,2012102303,100235643,2012110001673291,31DEC2021:00:00:00,,24,13,SUBVENTION_AMORTIZATION,24347208,22631446,1715762,3.750000,5.023281,1643736,913020,1136841,223821,1491941,117,FITIN1,SFNFIX,FASTCD,FTCDPREZO6,9,1,baont,14DEC2020:15:33:39,,,11DEC2020:00:00:00
1450,2012102303,100235643,2012110001673291,31JAN2022:00:00:00,,24,14,SUBVENTION_AMORTIZATION,22703472,21211531,1491941,3.750000,5.023281,1705376,851380,1065515,214135,1277806,117,FITIN1,SFNFIX,FASTCD,FTCDPREZO6,9,1,baont,14DEC2020:15:33:39,,,11DEC2020:00:00:00
1451,2012102303,100235643,2012110001673291,28FEB2022:00:00:00,,24,15,SUBVENTION_AMORTIZATION,20998096,19720290,1277806,3.750000,5.023281,1769327,787429,990606,203177,1074629,117,FITIN1,SFNFIX,FASTCD,FTCDPREZO6,9,1,baont,14DEC2020:15:33:39,,,11DEC2020:00:00:00
1452,2012102303,100235643,2012110001673291,31MAR2022:00:00:00,,24,16,SUBVENTION_AMORTIZATION,19228769,18154140,1074629,3.750000,5.023281,1835677,721079,911933,190854,883775,117,FITIN1,SFNFIX,FASTCD,FTCDPREZO6,9,1,baont,14DEC2020:15:33:39,,,11DEC2020:00:00:00
1453,2012102303,100235643,2012110001673291,30APR2022:00:00:00,,24,17,SUBVENTION_AMORTIZATION,17393092,16509317,883775,3.750000,5.023281,1904515,652241,829309,177068,706707,117,FITIN1,SFNFIX,FASTCD,FTCDPREZO6,9,1,baont,14DEC2020:15:33:39,,,11DEC2020:00:00:00
1454,2012102303,100235643,2012110001673291,31MAY2022:00:00:00,,24,18,SUBVENTION_AMORTIZATION,15488577,14781870,706707,3.750000,5.023281,1975934,580822,742535,161713,544994,117,FITIN1,SFNFIX,FASTCD,FTCDPREZO6,9,1,baont,14DEC2020:15:33:39,,,11DEC2020:00:00:00
1455,2012102303,100235643,2012110001673291,30JUN2022:00:00:00,,24,19,SUBVENTION_AMORTIZATION,13512643,12967649,544994,3.750000,5.023281,2050032,506724,651401,144677,400317,117,FITIN1,SFNFIX,FASTCD,FTCDPREZO6,9,1,baont,14DEC2020:15:33:39,,,11DEC2020:00:00:00
1456,2012102303,100235643,2012110001673291,31JUL2022:00:00:00,,24,20,SUBVENTION_AMORTIZATION,11462611,11062294,400317,3.750000,5.023281,2126908,429848,555690,125842,274475,117,FITIN1,SFNFIX,FASTCD,FTCDPREZO6,9,1,baont,14DEC2020:15:33:39,,,11DEC2020:00:00:00
1457,2012102303,100235643,2012110001673291,31AUG2022:00:00:00,,24,21,SUBVENTION_AMORTIZATION,9335703,9061228,274475,3.750000,5.023281,2206667,350089,455171,105082,169393,117,FITIN1,SFNFIX,FASTCD,FTCDPREZO6,9,1,baont,14DEC2020:15:33:39,,,11DEC2020:00:00:00
1458,2012102303,100235643,2012110001673291,30SEP2022:00:00:00,,24,22,SUBVENTION_AMORTIZATION,7129036,6959643,169393,3.750000,5.023281,2289417,267339,349602,82263,87130,117,FITIN1,SFNFIX,FASTCD,FTCDPREZO6,9,1,baont,14DEC2020:15:33:39,,,11DEC2020:00:00:00
1459,2012102303,100235643,2012110001673291,31OCT2022:00:00:00,,24,23,SUBVENTION_AMORTIZATION,4839619,4752489,87130,3.750000,5.023281,2375270,181486,238731,57245,29885,117,FITIN1,SFNFIX,FASTCD,FTCDPREZO6,9,1,baont,14DEC2020:15:33:39,,,11DEC2020:00:00:00
1460,2012102303,100235643,2012110001673291,30NOV2022:00:00:00,,24,24,SUBVENTION_AMORTIZATION,2464349,2434464,29885,3.750000,5.023281,2464349,92413,122290,29885,0,117,FITIN1,SFNFIX,FASTCD,FTCDPREZO6,9,1,baont,14DEC2020:15:33:39,,,11DEC2020:00:00:00
1532,2012142454,100235683,2012140001673327,31MAR2021:00:00:00,,12,4,SUBVENTION_AMORTIZATION_VAT,30208817,27578753,2630064,3.750000,5.784360,2883890,1132831,1595254,462423,2167641,20201025083,VTL,SFNFIX,FTCDZO,FTCDPRESUB5,61,1,baont,15DEC2020:09:11:36,,,14DEC2020:00:00:00
1533,2012142454,100235683,2012140001673327,30APR2021:00:00:00,,12,5,SUBVENTION_AMORTIZATION_VAT,27324927,25157286,2167641,3.750000,5.784360,2992036,1024685,1455188,430503,1737138,20201025083,VTL,SFNFIX,FTCDZO,FTCDPRESUB5,61,1,baont,15DEC2020:09:11:36,,,14DEC2020:00:00:00
1534,2012142454,100235683,2012140001673327,31MAY2021:00:00:00,,12,6,SUBVENTION_AMORTIZATION_VAT,24332891,22595753,1737138,3.750000,5.784360,3104238,912483,1307020,394537,1342601,20201025083,VTL,SFNFIX,FTCDZO,FTCDPRESUB5,61,1,baont,15DEC2020:09:11:36,,,14DEC2020:00:00:00
1535,2012142454,100235683,2012140001673327,30JUN2021:00:00:00,,12,7,SUBVENTION_AMORTIZATION_VAT,21228653,19886052,1342601,3.750000,5.784360,3220647,796074,1150281,354207,988394,20201025083,VTL,SFNFIX,FTCDZO,FTCDPRESUB5,61,1,baont,15DEC2020:09:11:36,,,14DEC2020:00:00:00
1536,2012142454,100235683,2012140001673327,31JUL2021:00:00:00,,12,8,SUBVENTION_AMORTIZATION_VAT,18008006,17019612,988394,3.750000,5.784360,3341421,675300,984476,309176,679218,20201025083,VTL,SFNFIX,FTCDZO,FTCDPRESUB5,61,1,baont,15DEC2020:09:11:36,,,14DEC2020:00:00:00
1537,2012142454,100235683,2012140001673327,31AUG2021:00:00:00,,12,9,SUBVENTION_AMORTIZATION_VAT,14666585,13987367,679218,3.750000,5.784360,3466724,549997,809080,259083,420135,20201025083,VTL,SFNFIX,FTCDZO,FTCDPRESUB5,61,1,baont,15DEC2020:09:11:36,,,14DEC2020:00:00:00
1538,2012142454,100235683,2012140001673327,30SEP2021:00:00:00,,12,10,SUBVENTION_AMORTIZATION_VAT,11199861,10779726,420135,3.750000,5.784360,3596726,419995,623538,203543,216592,20201025083,VTL,SFNFIX,FTCDZO,FTCDPRESUB5,61,1,baont,15DEC2020:09:11:36,,,14DEC2020:00:00:00
1539,2012142454,100235683,2012140001673327,31OCT2021:00:00:00,,12,11,SUBVENTION_AMORTIZATION_VAT,7603135,7386543,216592,3.750000,5.784360,3731603,285118,427264,142146,74446,20201025083,VTL,SFNFIX,FTCDZO,FTCDPRESUB5,61,1,baont,15DEC2020:09:11:36,,,14DEC2020:00:00:00
1540,2012142454,100235683,2012140001673327,30NOV2021:00:00:00,,12,12,SUBVENTION_AMORTIZATION_VAT,3871532,3797086,74446,3.750000,5.784360,3871532,145182,219637,74446,0,20201025083,VTL,SFNFIX,FTCDZO,FTCDPRESUB5,61,1,baont,15DEC2020:09:11:36,,,14DEC2020:00:00:00
1541,2012142494,100235693,2012140001673340,14DEC2020:00:00:00,,24,0,DISBURSE_SUBVENTION,40000000,35200000,4800000,3.750000,5.023281,,,,4800000,4800000,117,FITIN1,SFNFIX,FTCDZO,FTCDPREZO6,9,9,baont,15DEC2020:09:11:37,baont,15DEC2020:09:19:32,14DEC2020:00:00:00
1542,2012142494,100235693,2012140001673340,31DEC2020:00:00:00,,24,1,SUBVENTION_AMORTIZATION,40000000,35200000,4800000,3.750000,5.023281,1056756,1500000,1768195,268195,4531805,117,FITIN1,SFNFIX,FTCDZO,FTCDPREZO6,9,1,baont,15DEC2020:09:11:37,,,14DEC2020:00:00:00
1543,2012142494,100235693,2012140001673340,31JAN2021:00:00:00,,24,2,SUBVENTION_AMORTIZATION,38943244,34411439,4531805,3.750000,5.023281,1096384,1460372,1728583,268211,4263594,117,FITIN1,SFNFIX,FTCDZO,FTCDPREZO6,9,1,baont,15DEC2020:09:11:37,,,14DEC2020:00:00:00
1544,2012142494,100235693,2012140001673340,28FEB2021:00:00:00,,24,3,SUBVENTION_AMORTIZATION,37846860,33583266,4263594,3.750000,5.023281,1137499,1419257,1686982,267725,3995869,117,FITIN1,SFNFIX,FTCDZO,FTCDPREZO6,9,1,baont,15DEC2020:09:11:37,,,14DEC2020:00:00:00
1545,2012142494,100235693,2012140001673340,31MAR2021:00:00:00,,24,4,SUBVENTION_AMORTIZATION,36709361,32713492,3995869,3.750000,5.023281,1180155,1376601,1643291,266690,3729179,117,FITIN1,SFNFIX,FTCDZO,FTCDPREZO6,9,1,baont,15DEC2020:09:11:37,,,14DEC2020:00:00:00
1546,2012142494,100235693,2012140001673340,30APR2021:00:00:00,,24,5,SUBVENTION_AMORTIZATION,35529206,31800027,3729179,3.750000,5.023281,1224411,1332345,1597405,265060,3464119,117,FITIN1,SFNFIX,FTCDZO,FTCDPREZO6,9,1,baont,15DEC2020:09:11:37,,,14DEC2020:00:00:00
1547,2012142494,100235693,2012140001673340,31MAY2021:00:00:00,,24,6,SUBVENTION_AMORTIZATION,34304795,30840676,3464119,3.750000,5.023281,1270326,1286430,1549214,262784,3201335,117,FITIN1,SFNFIX,FTCDZO,FTCDPREZO6,9,1,baont,15DEC2020:09:11:37,,,14DEC2020:00:00:00
1548,2012142494,100235693,2012140001673340,30JUN2021:00:00:00,,24,7,SUBVENTION_AMORTIZATION,33034469,29833134,3201335,3.750000,5.023281,1317963,1238793,1498602,259809,2941526,117,FITIN1,SFNFIX,FTCDZO,FTCDPREZO6,9,1,baont,15DEC2020:09:11:37,,,14DEC2020:00:00:00
1549,2012142494,100235693,2012140001673340,31JUL2021:00:00:00,,24,8,SUBVENTION_AMORTIZATION,31716506,28774980,2941526,3.750000,5.023281,1367387,1189369,1445448,256079,2685447,117,FITIN1,SFNFIX,FTCDZO,FTCDPREZO6,9,1,baont,15DEC2020:09:11:37,,,14DEC2020:00:00:00
1550,2012142494,100235693,2012140001673340,31AUG2021:00:00:00,,24,9,SUBVENTION_AMORTIZATION,30349119,27663672,2685447,3.750000,5.023281,1418664,1138092,1389624,251532,2433915,117,FITIN1,SFNFIX,FTCDZO,FTCDPREZO6,9,1,baont,15DEC2020:09:11:37,,,14DEC2020:00:00:00
1551,2012142494,100235693,2012140001673340,30SEP2021:00:00:00,,24,10,SUBVENTION_AMORTIZATION,28930455,26496540,2433915,3.750000,5.023281,1471864,1084892,1330996,246104,2187811,117,FITIN1,SFNFIX,FTCDZO,FTCDPREZO6,9,1,baont,15DEC2020:09:11:37,,,14DEC2020:00:00:00
1552,2012142494,100235693,2012140001673340,31OCT2021:00:00:00,,24,11,SUBVENTION_AMORTIZATION,27458591,25270780,2187811,3.750000,5.023281,1527059,1029697,1269422,239725,1948086,117,FITIN1,SFNFIX,FTCDZO,FTCDPREZO6,9,1,baont,15DEC2020:09:11:37,,,14DEC2020:00:00:00
1553,2012142494,100235693,2012140001673340,30NOV2021:00:00:00,,24,12,SUBVENTION_AMORTIZATION,25931532,23983446,1948086,3.750000,5.023281,1584324,972432,1204756,232324,1715762,117,FITIN1,SFNFIX,FTCDZO,FTCDPREZO6,9,1,baont,15DEC2020:09:11:37,,,14DEC2020:00:00:00
1554,2012142494,100235693,2012140001673340,31DEC2021:00:00:00,,24,13,SUBVENTION_AMORTIZATION,24347208,22631446,1715762,3.750000,5.023281,1643736,913020,1136841,223821,1491941,117,FITIN1,SFNFIX,FTCDZO,FTCDPREZO6,9,1,baont,15DEC2020:09:11:37,,,14DEC2020:00:00:00
1555,2012142494,100235693,2012140001673340,31JAN2022:00:00:00,,24,14,SUBVENTION_AMORTIZATION,22703472,21211531,1491941,3.750000,5.023281,1705376,851380,1065515,214135,1277806,117,FITIN1,SFNFIX,FTCDZO,FTCDPREZO6,9,1,baont,15DEC2020:09:11:37,,,14DEC2020:00:00:00
1556,2012142494,100235693,2012140001673340,28FEB2022:00:00:00,,24,15,SUBVENTION_AMORTIZATION,20998096,19720290,1277806,3.750000,5.023281,1769327,787429,990606,203177,1074629,117,FITIN1,SFNFIX,FTCDZO,FTCDPREZO6,9,1,baont,15DEC2020:09:11:37,,,14DEC2020:00:00:00
1557,2012142494,100235693,2012140001673340,31MAR2022:00:00:00,,24,16,SUBVENTION_AMORTIZATION,19228769,18154140,1074629,3.750000,5.023281,1835677,721079,911933,190854,883775,117,FITIN1,SFNFIX,FTCDZO,FTCDPREZO6,9,1,baont,15DEC2020:09:11:37,,,14DEC2020:00:00:00
1558,2012142494,100235693,2012140001673340,30APR2022:00:00:00,,24,17,SUBVENTION_AMORTIZATION,17393092,16509317,883775,3.750000,5.023281,1904515,652241,829309,177068,706707,117,FITIN1,SFNFIX,FTCDZO,FTCDPREZO6,9,1,baont,15DEC2020:09:11:37,,,14DEC2020:00:00:00
1559,2012142494,100235693,2012140001673340,31MAY2022:00:00:00,,24,18,SUBVENTION_AMORTIZATION,15488577,14781870,706707,3.750000,5.023281,1975934,580822,742535,161713,544994,117,FITIN1,SFNFIX,FTCDZO,FTCDPREZO6,9,1,baont,15DEC2020:09:11:37,,,14DEC2020:00:00:00
1560,2012142494,100235693,2012140001673340,30JUN2022:00:00:00,,24,19,SUBVENTION_AMORTIZATION,13512643,12967649,544994,3.750000,5.023281,2050032,506724,651401,144677,400317,117,FITIN1,SFNFIX,FTCDZO,FTCDPREZO6,9,1,baont,15DEC2020:09:11:37,,,14DEC2020:00:00:00
1561,2012142494,100235693,2012140001673340,31JUL2022:00:00:00,,24,20,SUBVENTION_AMORTIZATION,11462611,11062294,400317,3.750000,5.023281,2126908,429848,555690,125842,274475,117,FITIN1,SFNFIX,FTCDZO,FTCDPREZO6,9,1,baont,15DEC2020:09:11:37,,,14DEC2020:00:00:00
1562,2012142494,100235693,2012140001673340,31AUG2022:00:00:00,,24,21,SUBVENTION_AMORTIZATION,9335703,9061228,274475,3.750000,5.023281,2206667,350089,455171,105082,169393,117,FITIN1,SFNFIX,FTCDZO,FTCDPREZO6,9,1,baont,15DEC2020:09:11:37,,,14DEC2020:00:00:00
1563,2012142494,100235693,2012140001673340,30SEP2022:00:00:00,,24,22,SUBVENTION_AMORTIZATION,7129036,6959643,169393,3.750000,5.023281,2289417,267339,349602,82263,87130,117,FITIN1,SFNFIX,FTCDZO,FTCDPREZO6,9,1,baont,15DEC2020:09:11:37,,,14DEC2020:00:00:00
1564,2012142494,100235693,2012140001673340,31OCT2022:00:00:00,,24,23,SUBVENTION_AMORTIZATION,4839619,4752489,87130,3.750000,5.023281,2375270,181486,238731,57245,29885,117,FITIN1,SFNFIX,FTCDZO,FTCDPREZO6,9,1,baont,15DEC2020:09:11:37,,,14DEC2020:00:00:00
1565,2012142494,100235693,2012140001673340,30NOV2022:00:00:00,,24,24,SUBVENTION_AMORTIZATION,2464349,2434464,29885,3.750000,5.023281,2464349,92413,122290,29885,0,117,FITIN1,SFNFIX,FTCDZO,FTCDPREZO6,9,1,baont,15DEC2020:09:11:37,,,14DEC2020:00:00:00
1566,2012142497,100235687,2012140001673338,14DEC2020:00:00:00,,12,0,DISBURSE_SUBVENTION_VAT_POST,6000000,4909091,1090909,3.750000,7.362955,,,,1090909,1090909,16,NK,SFNFIX,FTCDZO,FTCDPOSTZO1,57,9,baont,15DEC2020:09:11:39,baont,15DEC2020:09:19:32,14DEC2020:00:00:00
1567,2012142497,100235687,2012140001673338,14DEC2020:00:00:00,,12,0,DISBURSE_SUBVENTION_VAT_TOTAL_POST,6000000,4909091,1090909,3.750000,7.362955,,,,1200000,1090909,16,NK,SFNFIX,FTCDZO,FTCDPOSTZO1,57,9,baont,15DEC2020:09:11:39,baont,15DEC2020:09:19:32,14DEC2020:00:00:00
1568,2012142497,100235687,2012140001673338,14DEC2020:00:00:00,,12,0,DISBURSE_SUBVENTION_VAT_AMT_POST,6000000,4909091,1090909,3.750000,7.362955,,,,109091,1090909,16,NK,SFNFIX,FTCDZO,FTCDPOSTZO1,57,9,baont,15DEC2020:09:11:39,baont,15DEC2020:09:19:32,14DEC2020:00:00:00
1569,2012142497,100235687,2012140001673338,31DEC2020:00:00:00,,12,1,SUBVENTION_AMORTIZATION_VAT_POST,6000000,4909091,1090909,3.750000,7.362955,405074,225000,361454,136454,954455,16,NK,SFNFIX,FTCDZO,FTCDPOSTZO1,57,1,baont,15DEC2020:09:11:39,,,14DEC2020:00:00:00
1570,2012142497,100235687,2012140001673338,31JAN2021:00:00:00,,12,2,SUBVENTION_AMORTIZATION_VAT_POST,5594926,4640471,954455,3.750000,7.362955,420264,209810,341676,131866,822589,16,NK,SFNFIX,FTCDZO,FTCDPOSTZO1,57,1,baont,15DEC2020:09:11:39,,,14DEC2020:00:00:00
1571,2012142497,100235687,2012140001673338,28FEB2021:00:00:00,,12,3,SUBVENTION_AMORTIZATION_VAT_POST,5174662,4352073,822589,3.750000,7.362955,436024,194050,320441,126391,696198,16,NK,SFNFIX,FTCDZO,FTCDPOSTZO1,57,1,baont,15DEC2020:09:11:39,,,14DEC2020:00:00:00
1572,2012142497,100235687,2012140001673338,31MAR2021:00:00:00,,12,4,SUBVENTION_AMORTIZATION_VAT_POST,4738638,4042440,696198,3.750000,7.362955,452375,177699,297643,119944,576254,16,NK,SFNFIX,FTCDZO,FTCDPOSTZO1,57,1,baont,15DEC2020:09:11:39,,,14DEC2020:00:00:00
1573,2012142497,100235687,2012140001673338,30APR2021:00:00:00,,12,5,SUBVENTION_AMORTIZATION_VAT_POST,4286263,3710009,576254,3.750000,7.362955,469339,160735,273166,112431,463823,16,NK,SFNFIX,FTCDZO,FTCDPOSTZO1,57,1,baont,15DEC2020:09:11:39,,,14DEC2020:00:00:00
1574,2012142497,100235687,2012140001673338,31MAY2021:00:00:00,,12,6,SUBVENTION_AMORTIZATION_VAT_POST,3816924,3353101,463823,3.750000,7.362955,486939,143135,246887,103752,360071,16,NK,SFNFIX,FTCDZO,FTCDPOSTZO1,57,1,baont,15DEC2020:09:11:39,,,14DEC2020:00:00:00
1575,2012142497,100235687,2012140001673338,30JUN2021:00:00:00,,12,7,SUBVENTION_AMORTIZATION_VAT_POST,3329985,2969914,360071,3.750000,7.362955,505200,124874,218673,93799,266272,16,NK,SFNFIX,FTCDZO,FTCDPOSTZO1,57,1,baont,15DEC2020:09:11:39,,,14DEC2020:00:00:00
1576,2012142497,100235687,2012140001673338,31JUL2021:00:00:00,,12,8,SUBVENTION_AMORTIZATION_VAT_POST,2824785,2558513,266272,3.750000,7.362955,524145,105929,188382,82453,183819,16,NK,SFNFIX,FTCDZO,FTCDPOSTZO1,57,1,baont,15DEC2020:09:11:39,,,14DEC2020:00:00:00
1577,2012142497,100235687,2012140001673338,31AUG2021:00:00:00,,12,9,SUBVENTION_AMORTIZATION_VAT_POST,2300640,2116821,183819,3.750000,7.362955,543800,86274,155861,69587,114232,16,NK,SFNFIX,FTCDZO,FTCDPOSTZO1,57,1,baont,15DEC2020:09:11:39,,,14DEC2020:00:00:00
1578,2012142497,100235687,2012140001673338,30SEP2021:00:00:00,,12,10,SUBVENTION_AMORTIZATION_VAT_POST,1756840,1642608,114232,3.750000,7.362955,564192,65882,120944,55062,59170,16,NK,SFNFIX,FTCDZO,FTCDPOSTZO1,57,1,baont,15DEC2020:09:11:39,,,14DEC2020:00:00:00
1579,2012142497,100235687,2012140001673338,31OCT2021:00:00:00,,12,11,SUBVENTION_AMORTIZATION_VAT_POST,1192648,1133478,59170,3.750000,7.362955,585350,44724,83457,38733,20437,16,NK,SFNFIX,FTCDZO,FTCDPOSTZO1,57,1,baont,15DEC2020:09:11:39,,,14DEC2020:00:00:00
1580,2012142497,100235687,2012140001673338,30NOV2021:00:00:00,,12,12,SUBVENTION_AMORTIZATION_VAT_POST,607298,586861,20437,3.750000,7.362955,607298,22774,43210,20437,0,16,NK,SFNFIX,FTCDZO,FTCDPOSTZO1,57,1,baont,15DEC2020:09:11:39,,,14DEC2020:00:00:00
1581,2012142496,100235689,2012140001673341,14DEC2020:00:00:00,,24,0,DISBURSE_SUBVENTION_POST,25000000,22000000,3000000,3.750000,5.023284,,,,3000000,3000000,20201025085,FITIN,SFNFIX,FTCDZO,FTCDPOSTSUB1,25,9,baont,15DEC2020:09:11:39,baont,15DEC2020:09:19:32,14DEC2020:00:00:00
1582,2012142496,100235689,2012140001673341,31DEC2020:00:00:00,,24,1,SUBVENTION_AMORTIZATION_POST,25000000,22000000,3000000,3.750000,5.023284,660473,937500,1105122,167622,2832378,20201025085,FITIN,SFNFIX,FTCDZO,FTCDPOSTSUB1,25,1,baont,15DEC2020:09:11:39,,,14DEC2020:00:00:00
1583,2012142496,100235689,2012140001673341,31JAN2021:00:00:00,,24,2,SUBVENTION_AMORTIZATION_POST,24339527,21507149,2832378,3.750000,5.023284,685241,912732,1080365,167633,2664745,20201025085,FITIN,SFNFIX,FTCDZO,FTCDPOSTSUB1,25,1,baont,15DEC2020:09:11:39,,,14DEC2020:00:00:00
1584,2012142496,100235689,2012140001673341,28FEB2021:00:00:00,,24,3,SUBVENTION_AMORTIZATION_POST,23654286,20989541,2664745,3.750000,5.023284,710937,887036,1054364,167328,2497417,20201025085,FITIN,SFNFIX,FTCDZO,FTCDPOSTSUB1,25,1,baont,15DEC2020:09:11:39,,,14DEC2020:00:00:00
1585,2012142496,100235689,2012140001673341,31MAR2021:00:00:00,,24,4,SUBVENTION_AMORTIZATION_POST,22943349,20445932,2497417,3.750000,5.023284,737597,860376,1027057,166681,2330736,20201025085,FITIN,SFNFIX,FTCDZO,FTCDPOSTSUB1,25,1,baont,15DEC2020:09:11:39,,,14DEC2020:00:00:00
1586,2012142496,100235689,2012140001673341,30APR2021:00:00:00,,24,5,SUBVENTION_AMORTIZATION_POST,22205752,19875016,2330736,3.750000,5.023284,765257,832716,998378,165662,2165074,20201025085,FITIN,SFNFIX,FTCDZO,FTCDPOSTSUB1,25,1,baont,15DEC2020:09:11:39,,,14DEC2020:00:00:00
1587,2012142496,100235689,2012140001673341,31MAY2021:00:00:00,,24,6,SUBVENTION_AMORTIZATION_POST,21440495,19275421,2165074,3.750000,5.023284,793954,804019,968259,164240,2000834,20201025085,FITIN,SFNFIX,FTCDZO,FTCDPOSTSUB1,25,1,baont,15DEC2020:09:11:39,,,14DEC2020:00:00:00
1588,2012142496,100235689,2012140001673341,30JUN2021:00:00:00,,24,7,SUBVENTION_AMORTIZATION_POST,20646541,18645707,2000834,3.750000,5.023284,823728,774245,936627,162382,1838452,20201025085,FITIN,SFNFIX,FTCDZO,FTCDPOSTSUB1,25,1,baont,15DEC2020:09:11:39,,,14DEC2020:00:00:00
1589,2012142496,100235689,2012140001673341,31JUL2021:00:00:00,,24,8,SUBVENTION_AMORTIZATION_POST,19822813,17984361,1838452,3.750000,5.023284,854618,743355,903406,160051,1678401,20201025085,FITIN,SFNFIX,FTCDZO,FTCDPOSTSUB1,25,1,baont,15DEC2020:09:11:39,,,14DEC2020:00:00:00
1590,2012142496,100235689,2012140001673341,31AUG2021:00:00:00,,24,9,SUBVENTION_AMORTIZATION_POST,18968195,17289794,1678401,3.750000,5.023284,886666,711307,868515,157208,1521193,20201025085,FITIN,SFNFIX,FTCDZO,FTCDPOSTSUB1,25,1,baont,15DEC2020:09:11:39,,,14DEC2020:00:00:00
1591,2012142496,100235689,2012140001673341,30SEP2021:00:00:00,,24,10,SUBVENTION_AMORTIZATION_POST,18081529,16560336,1521193,3.750000,5.023284,919916,678057,831873,153816,1367377,20201025085,FITIN,SFNFIX,FTCDZO,FTCDPOSTSUB1,25,1,baont,15DEC2020:09:11:39,,,14DEC2020:00:00:00
1592,2012142496,100235689,2012140001673341,31OCT2021:00:00:00,,24,11,SUBVENTION_AMORTIZATION_POST,17161613,15794236,1367377,3.750000,5.023284,954413,643560,793389,149829,1217548,20201025085,FITIN,SFNFIX,FTCDZO,FTCDPOSTSUB1,25,1,baont,15DEC2020:09:11:39,,,14DEC2020:00:00:00
1593,2012142496,100235689,2012140001673341,30NOV2021:00:00:00,,24,12,SUBVENTION_AMORTIZATION_POST,16207200,14989652,1217548,3.750000,5.023284,990203,607770,752973,145203,1072345,20201025085,FITIN,SFNFIX,FTCDZO,FTCDPOSTSUB1,25,1,baont,15DEC2020:09:11:39,,,14DEC2020:00:00:00
1594,2012142496,100235689,2012140001673341,31DEC2021:00:00:00,,24,13,SUBVENTION_AMORTIZATION_POST,15216997,14144652,1072345,3.750000,5.023284,1027336,570637,710526,139889,932456,20201025085,FITIN,SFNFIX,FTCDZO,FTCDPOSTSUB1,25,1,baont,15DEC2020:09:11:39,,,14DEC2020:00:00:00
1595,2012142496,100235689,2012140001673341,31JAN2022:00:00:00,,24,14,SUBVENTION_AMORTIZATION_POST,14189661,13257205,932456,3.750000,5.023284,1065861,532112,665947,133835,798621,20201025085,FITIN,SFNFIX,FTCDZO,FTCDPOSTSUB1,25,1,baont,15DEC2020:09:11:39,,,14DEC2020:00:00:00
1596,2012142496,100235689,2012140001673341,28FEB2022:00:00:00,,24,15,SUBVENTION_AMORTIZATION_POST,13123800,12325179,798621,3.750000,5.023284,1105830,492143,619129,126986,671635,20201025085,FITIN,SFNFIX,FTCDZO,FTCDPOSTSUB1,25,1,baont,15DEC2020:09:11:39,,,14DEC2020:00:00:00
1597,2012142496,100235689,2012140001673341,31MAR2022:00:00:00,,24,16,SUBVENTION_AMORTIZATION_POST,12017970,11346335,671635,3.750000,5.023284,1147299,450674,569959,119285,552350,20201025085,FITIN,SFNFIX,FTCDZO,FTCDPOSTSUB1,25,1,baont,15DEC2020:09:11:39,,,14DEC2020:00:00:00
1598,2012142496,100235689,2012140001673341,30APR2022:00:00:00,,24,17,SUBVENTION_AMORTIZATION_POST,10870671,10318321,552350,3.750000,5.023284,1190323,407650,518319,110669,441681,20201025085,FITIN,SFNFIX,FTCDZO,FTCDPOSTSUB1,25,1,baont,15DEC2020:09:11:39,,,14DEC2020:00:00:00
